b l o r p	b l o r p o
v u g	v u g o
g o s p o dj i n	g o s p o dj i n a
a b a zh u r	a b a zh u r a
a b a z	a b a z a
a b a zj i n	a b a zj i n a
a b a k	a b a k a
a b b a t	a b b a t a
a b d o mj e n	a b d o mj e n a
a b d u k t o r	a b d u k t o r a
a bj e lj i t	a bj e lj i t a
a b z a ts	a b z a ts a
a bj i j e tj i n	a bj i j e tj i n a
a bj i t u rj i j e n t	a bj i t u rj i j e n t a
a b lj a tj i v	a b lj a tj i v a
a b lj a u t	a b lj a u t a
a b o lj i ts i o nj i z m	a b o lj i ts i o nj i z m a
a b o lj i ts i o nj i s t	a b o lj i ts i o nj i s t a
a b o nj e mj e n t	a b o nj e mj e n t a
a b o nj e n t	a b o nj e n t a
a b o r d a zh	a b o r d a zh a
a b o rj i gj e n	a b o rj i gj e n a
a b o r t	a b o r t a
a b o r t a rj i j	a b o r t a rj i j a
a b r a zj i v	a b r a zj i v a
a b rj e k	a b rj e k a
a b rj i k o s	a b rj i k o s a
a b rj i k o tj i n	a b rj i k o tj i n a
a b rj i s	a b rj i s a
a b sj e n t	a b sj e n t a
a b sj e n tj e j i z m	a b sj e n tj e j i z m a
a b sj e n tj e j i s t	a b sj e n tj e j i s t a
a b s o lj u t	a b s o lj u t a
a b s o lj u tj i z m	a b s o lj u tj i z m a
a b s o lj u tj i s t	a b s o lj u tj i s t a
a b s o r bj e n t	a b s o r bj e n t a
a b s o r bj e r	a b s o r bj e r a
a b s tj i nj e n t	a b s tj i nj e n t a
a b s t r a k t	a b s t r a k t a
a b s t r a k ts i o nj i z m	a b s t r a k ts i o nj i z m a
a b s t r a k ts i o nj i s t	a b s t r a k ts i o nj i s t a
a b s u r d	a b s u r d a
a b s ts e s s	a b s ts e s s a
a b x a z	a b x a z a
a b ts u g	a b ts u g a
a b sh t rj i x	a b sh t rj i x a
a v a lj i s t	a v a lj i s t a
a v a lj	a v a lj a
a v a n g a r d	a v a n g a r d a
a v a n g a r dj i z m	a v a n g a r dj i z m a
a v a n g a r dj i s t	a v a n g a r dj i s t a
a v a n z a l	a v a n z a l a
a v a n p o r t	a v a n p o r t a
a v a n p o s t	a v a n p o s t a
a v a n s	a v a n s a
a v a n t a zh	a v a n t a zh a
a v a n tj u rj i z m	a v a n tj u rj i z m a
a v a n tj u rj i n	a v a n tj u rj i n a
a v a n tj u rj i s t	a v a n tj u rj i s t a
a v a rj i j shshj i k	a v a rj i j shshj i k a
a v gj i t	a v gj i t a
a v g u r	a v g u r a
a v g u s t	a v g u s t a
a vj e r s	a vj e r s a
a vj i a bj e n zj i n	a vj i a bj e n zj i n a
a vj i a g o rj i z o n t	a vj i a g o rj i z o n t a
a vj i a d vj i g a tj e lj	a vj i a d vj i g a tj e lj a
a vj i a dj e s a n t	a vj i a dj e s a n t a
a vj i a z a v o d	a vj i a z a v o d a
a vj i a k o n s t r u k t o r	a vj i a k o n s t r u k t o r a
a vj i a m o dj e lj i z m	a vj i a m o dj e lj i z m a
a vj i a m o dj e lj i s t	a vj i a m o dj e lj i s t a
a vj i a m o t o r	a vj i a m o t o r a
a vj i a p rj i b o r	a vj i a p rj i b o r a
a vj i a s t r o j i tj e lj	a vj i a s t r o j i tj e lj a
a vj i a tj e x nj i k	a vj i a tj e x nj i k a
a vj i a t o r	a vj i a t o r a
a vj i a t r a n s p o r t	a vj i a t r a n s p o r t a
a vj i t a mj i n o z	a vj i t a mj i n o z a
a v r a l	a v r a l a
a v r a n	a v r a n a
a v s t r a l o pj i tj e k	a v s t r a l o pj i tj e k a
a v s t rj i j a k	a v s t rj i j a k a
a v t o b u s	a v t o b u s a
a v t o b u s nj i k	a v t o b u s nj i k a
a v t o v o k z a l	a v t o v o k z a l a
a v t o gj e n	a v t o gj e n a
a v t o gj e nj e z	a v t o gj e nj e z a
a v t o gj e nj e r a t o r	a v t o gj e nj e r a t o r a
a v t o gj e n shshj i k	a v t o gj e n shshj i k a
a v t o gj i p n o z	a v t o gj i p n o z a
a v t o g r a f	a v t o g r a f a
a v t o dj i d a k t	a v t o dj i d a k t a
a v t o d o r o zh nj i k	a v t o d o r o zh nj i k a
a v t o d r o m	a v t o d r o m a
a v t o zh i r	a v t o zh i r a
a v t o z a v o d	a v t o z a v o d a
a v t o z a p r a v shshj i k	a v t o z a p r a v shshj i k a
a v t o j i n s pj e k t o r	a v t o j i n s pj e k t o r a
a v t o j i n s pj e k t o r	a v t o j i n s pj e k t o r a
a v t o k a r	a v t o k a r a