a k j ə p aɪ	a k j ə p aɪ d
a n ɚ	a n ɚ d
a r ɡ j u	a r ɡ j u d
a r m	a r m d
a r t ɪ k ə l	a r t ɪ k ə l d
æ d ə l	æ d ə l d
æ d h i r	æ d h i r d
æ d v ɚ t aɪ z	æ d v ɚ t aɪ z d
æ ɡ ə n aɪ z	æ ɡ ə n aɪ z d
æ m b ə l	æ m b ə l d
æ m oʊ r t aɪ z	æ m oʊ r t aɪ z d
æ m p l ɪ f aɪ	æ m p l ɪ f aɪ d
æ n ə l aɪ z	æ n ə l aɪ z d
æ n s ɚ	æ n s ɚ d
æ n t æ ɡ ə n aɪ z	æ n t æ ɡ ə n aɪ z d
æ ŋ ɡ ə l	æ ŋ ɡ ə l d
æ ŋ ɡ ɚ	æ ŋ ɡ ɚ d
æ ŋ ɡ l ɪ s aɪ z	æ ŋ ɡ l ɪ s aɪ z d
æ ŋ k ɚ	æ ŋ k ɚ d
æ s ɚ t eɪ n	æ s ɚ t eɪ n d
æ t r ə f i	æ t r ə f i d
æ v ɚ ɪ ʤ	æ v ɚ ɪ ʤ d
aɪ	aɪ d
aɪ d ə l	aɪ d ə l d
aɪ d ə l aɪ z	aɪ d ə l aɪ z d
aɪ d ɛ n t ə f aɪ	aɪ d ɛ n t ə f aɪ d
aɪ d i ə l aɪ z	aɪ d i ə l aɪ z d
aɪ ɚ n	aɪ ɚ n d
aɪ t ə m aɪ z	aɪ t ə m aɪ z d
aʊ t l aɪ n	aʊ t l aɪ n d
aʊ t l ɪ v	aʊ t l ɪ v d
aʊ t l ɔ	aʊ t l ɔ d
aʊ t m ə n u v ɚ	aʊ t m ə n u v ɚ d
aʊ t n ʌ m b ɚ	aʊ t n ʌ m b ɚ d
aʊ t r eɪ ʤ	aʊ t r eɪ ʤ d
aʊ t w eɪ	aʊ t w eɪ d
b a b	b a b d
b a ð ɚ	b a ð ɚ d
b a ɡ ə l	b a ɡ ə l d
b a m	b a m d
b a r	b a r d
b a r ʤ	b a r ʤ d
b a r ɡ ɪ n	b a r ɡ ɪ n d
b a r oʊ	b a r oʊ d
b a r t ɚ	b a r t ɚ d
b a t ə l	b a t ə l d
b æ b ə l	b æ b ə l d
b æ ʤ ɚ	b æ ʤ ɚ d
b æ f ə l	b æ f ə l d
b æ ɡ	b æ ɡ d
b æ k f aɪ ɚ	b æ k f aɪ ɚ d
b æ n	b æ n d
b æ n d i	b æ n d i d
b æ n d ɪ ʤ	b æ n d ɪ ʤ d
b æ ŋ	b æ ŋ d
b æ p t aɪ z	b æ p t aɪ z d
b æ t ə l	b æ t ə l d
b æ t ɚ	b æ t ɚ d
b aɪ s ɪ k ə l	b aɪ s ɪ k ə l d
b aʊ	b aʊ d
b eɪ	b eɪ d
b eɪ ð	b eɪ ð d
b eɪ l	b eɪ l d
b eɪ r	b eɪ r d
b eɪ r i	b eɪ r i d
b ə l i v	b ə l i v d
b ə l ɔ ŋ	b ə l ɔ ŋ d
b ə l u n	b ə l u n d
b ɛ ɡ	b ɛ ɡ d
b ɛ k ə n	b ɛ k ə n d
b ɛ l	b ɛ l d
b ɛ l oʊ	b ɛ l oʊ d
b ɛ t ɚ	b ɛ t ɚ d
b ɚ b ə l	b ɚ b ə l d
b ɚ d ə n	b ɚ d ə n d
b ɚ ʤ ə n	b ɚ ʤ ə n d
b ɚ ɡ ə l	b ɚ ɡ ə l d
b ɚ n	b ɚ n d
b ɚ oʊ	b ɚ oʊ d
b i m	b i m d
b ɪ d ɛ v ə l	b ɪ d ɛ v ə l d
b ɪ f ʌ d ə l	b ɪ f ʌ d ə l d
b ɪ ɡ aɪ l	b ɪ ɡ aɪ l d
b ɪ ɡ r ʌ ʤ	b ɪ ɡ r ʌ ʤ d
b ɪ h eɪ v	b ɪ h eɪ v d
b ɪ k ɚ	b ɪ k ɚ d
b ɪ l	b ɪ l d
b ɪ l aɪ	b ɪ l aɪ d
b ɪ l eɪ	b ɪ l eɪ d
b ɪ l i ɡ ɚ	b ɪ l i ɡ ɚ d
b ɪ l ɪ t ə l	b ɪ l ɪ t ə l d
b ɪ l oʊ	b ɪ l oʊ d
b ɪ m oʊ n	b ɪ m oʊ n d
b ɪ s i ʤ	b ɪ s i ʤ d
b ɪ s t oʊ	b ɪ s t oʊ d
b ɪ t oʊ k ə n	b ɪ t oʊ k ə n d
b ɪ t r eɪ	b ɪ t r eɪ d
b ɪ w ɪ l d ɚ	b ɪ w ɪ l d ɚ d
b ɪ z i	b ɪ z i d
b l a s ə m	b l a s ə m d
b l æ k ə n	b l æ k ə n d
b l æ k m eɪ l	b l æ k m eɪ l d
b l eɪ m	b l eɪ m d
b l eɪ r	b l eɪ r d
b l eɪ z	b l eɪ z d
b l ɚ	b l ɚ d
b l ɪ s t ɚ	b l ɪ s t ɚ d
b l u m	b l u m d
b l ʌ b ɚ	b l ʌ b ɚ d
b l ʌ ʤ ə n	b l ʌ ʤ ə n d
b l ʌ n d ɚ	b l ʌ n d ɚ d
b l ʌ s t ɚ	b l ʌ s t ɚ d
b oʊ l	b oʊ l d
b oʊ l s t ɚ	b oʊ l s t ɚ d
b oʊ r	b oʊ r d
b oʊ r d ɚ	b oʊ r d ɚ d
b ɔ l	b ɔ l d
b ɔɪ	b ɔɪ d
b ɔɪ l	b ɔɪ l d
b r a n z	b r a n z d
b r æ ɡ	b r æ ɡ d
b r aɪ b	b r aɪ b d
b r aɪ d ə l	b r aɪ d ə l d
b r aɪ t ə n	b r aɪ t ə n d
b r aʊ n	b r aʊ n d
b r aʊ z	b r aʊ z d
b r eɪ	b r eɪ d
b r eɪ v	b r eɪ v d
b r i ð	b r i ð d
b r ɪ ʤ	b r ɪ ʤ d
b r ɪ m	b r ɪ m d
b r ɪ s ə l	b r ɪ s ə l d
b r ɔ d ə n	b r ɔ d ə n d
b r ɔɪ l	b r ɔɪ l d
b r u	b r u d
b r u t ə l aɪ z	b r u t ə l aɪ z d
b r u z	b r u z d
b u	b u d
b u m	b u m d
b u z	b u z d
b ʊ l d oʊ z	b ʊ l d oʊ z d
b ʊ l i	b ʊ l i d
b ʊ ʧ ɚ	b ʊ ʧ ɚ d
b ʌ b ə l	b ʌ b ə l d
b ʌ ʤ	b ʌ ʤ d
b ʌ ɡ	b ʌ ɡ d
b ʌ ɡ ɚ	b ʌ ɡ ɚ d
b ʌ k ə l	b ʌ k ə l d
b ʌ l ʤ	b ʌ l ʤ d
b ʌ m	b ʌ m d
b ʌ m b ə l	b ʌ m b ə l d
b ʌ n d ə l	b ʌ n d ə l d
b ʌ ŋ	b ʌ ŋ d
b ʌ ŋ ɡ ə l	b ʌ ŋ ɡ ə l d
b ʌ s ə l	b ʌ s ə l d
b ʌ t ə n	b ʌ t ə n d
b ʌ t ɚ	b ʌ t ɚ d
b ʌ z	b ʌ z d
d a ʤ	d a ʤ d
d a ɡ	d a ɡ d
d a k t ɚ	d a k t ɚ d
d a m ɪ n i r	d a m ɪ n i r d
d a n	d a n d
d a r k ə n	d a r k ə n d
d a r n	d a r n d
d æ b	d æ b d
d æ b ə l	d æ b ə l d
d æ l i	d æ l i d
d æ m	d æ m d
d æ m	d æ m d
d æ m ɪ ʤ	d æ m ɪ ʤ d
d æ m p ə n	d æ m p ə n d
d æ n d ə l	d æ n d ə l d
d æ ŋ ɡ ə l	d æ ŋ ɡ ə l d
d æ p ə l	d æ p ə l d
d æ z ə l	d æ z ə l d
d aɪ	d aɪ d
d aɪ	d aɪ d
d aɪ ə l	d aɪ ə l d
d aɪ n	d aɪ n d
d aɪ v ɚ ʤ	d aɪ v ɚ ʤ d
d aɪ v ʌ l ʤ	d aɪ v ʌ l ʤ d
d aʊ n	d aʊ n d
d eɪ d r i m	d eɪ d r i m d
d eɪ n	d eɪ n d
d eɪ r	d eɪ r d
d eɪ z	d eɪ z d
d ɛ d ə n	d ɛ d ə n d
d ɛ f ə n	d ɛ f ə n d
d ɛ l v	d ɛ l v d
d ɛ s t ɪ n	d ɛ s t ɪ n d
d ɚ t i	d ɚ t i d
d i f j u z	d i f j u z d
d i h j u m ə n aɪ z	d i h j u m ə n aɪ z d
d i k a l ə n aɪ z	d i k a l ə n aɪ z d
d i k ə m p oʊ z	d i k ə m p oʊ z d
d i m	d i m d
d i p ə n	d i p ə n d
d i r eɪ l	d i r eɪ l d
d i r eɪ n ʤ	d i r eɪ n ʤ d
d i s ɛ n t r ə l aɪ z	d i s ɛ n t r ə l aɪ z d
d i t eɪ l	d i t eɪ l d
d i v æ l j u	d i v æ l j u d
d ɪ f aɪ	d ɪ f aɪ d
d ɪ f aɪ l	d ɪ f aɪ l d
d ɪ f aɪ n	d ɪ f aɪ n d
d ɪ f eɪ m	d ɪ f eɪ m d
d ɪ f ɚ	d ɪ f ɚ d
d ɪ f ɚ	d ɪ f ɚ d
d ɪ f j u z	d ɪ f j u z d
d ɪ f oʊ r m	d ɪ f oʊ r m d
d ɪ ɡ n ɪ f aɪ	d ɪ ɡ n ɪ f aɪ d
d ɪ k eɪ	d ɪ k eɪ d
d ɪ k l aɪ n	d ɪ k l aɪ n d
d ɪ k l eɪ m	d ɪ k l eɪ m d
d ɪ k l eɪ r	d ɪ k l eɪ r d
d ɪ k r aɪ	d ɪ k r aɪ d
d ɪ k r i	d ɪ k r i d
d ɪ l eɪ	d ɪ l eɪ d
d ɪ l ɪ v ɚ	d ɪ l ɪ v ɚ d
d ɪ m	d ɪ m d
d ɪ m a k r ə t aɪ z	d ɪ m a k r ə t aɪ z d
d ɪ m ɚ	d ɪ m ɚ d
d ɪ m i n	d ɪ m i n d
d ɪ m oʊ r ə l aɪ z	d ɪ m oʊ r ə l aɪ z d
d ɪ m p ə l	d ɪ m p ə l d
d ɪ n aɪ	d ɪ n aɪ d
d ɪ p l oʊ r	d ɪ p l oʊ r d
d ɪ p l ɔɪ	d ɪ p l ɔɪ d
d ɪ p oʊ z	d ɪ p oʊ z d
d ɪ p r eɪ v	d ɪ p r eɪ v d
d ɪ s a n ɚ	d ɪ s a n ɚ d
d ɪ s a r m	d ɪ s a r m d
d ɪ s aɪ f ɚ	d ɪ s aɪ f ɚ d
d ɪ s b ɪ l i v	d ɪ s b ɪ l i v d
d ɪ s d eɪ n	d ɪ s d eɪ n d
d ɪ s eɪ b ə l	d ɪ s eɪ b ə l d
d ɪ s ə b eɪ	d ɪ s ə b eɪ d
d ɪ s ə ɡ r i	d ɪ s ə ɡ r i d
d ɪ s ə l aʊ	d ɪ s ə l aʊ d
d ɪ s ə p i r	d ɪ s ə p i r d
d ɪ s ə p r u v	d ɪ s ə p r u v d
d ɪ s ɛ m b ə l	d ɪ s ɛ m b ə l d
d ɪ s ɚ n	d ɪ s ɚ n d
d ɪ s f ɪ ɡ j ɚ	d ɪ s f ɪ ɡ j ɚ d
d ɪ s ɡ aɪ z	d ɪ s ɡ aɪ z d
d ɪ s ɡ oʊ r ʤ	d ɪ s ɡ oʊ r ʤ d
d ɪ s h a r t ə n	d ɪ s h a r t ə n d
d ɪ s i v	d ɪ s i v d
d ɪ s ɪ l u ʒ ə n	d ɪ s ɪ l u ʒ ə n d
d ɪ s ɪ m b aʊ ə l	d ɪ s ɪ m b aʊ ə l d
d ɪ s ɪ n ɡ eɪ ʤ	d ɪ s ɪ n ɡ eɪ ʤ d
d ɪ s ɪ n k l aɪ n	d ɪ s ɪ n k l aɪ n d
d ɪ s ɪ n t æ ŋ ɡ ə l	d ɪ s ɪ n t æ ŋ ɡ ə l d
d ɪ s ɪ n t ɚ	d ɪ s ɪ n t ɚ d
d ɪ s ɪ p l ɪ n	d ɪ s ɪ p l ɪ n d
d ɪ s k ə n t ɪ n j u	d ɪ s k ə n t ɪ n j u d
d ɪ s k ɚ ɪ ʤ	d ɪ s k ɚ ɪ ʤ d
d ɪ s k l eɪ m	d ɪ s k l eɪ m d
d ɪ s k l oʊ z	d ɪ s k l oʊ z d
d ɪ s k r aɪ b	d ɪ s k r aɪ b d
d ɪ s k ʌ l ɚ	d ɪ s k ʌ l ɚ d
d ɪ s k ʌ v ɚ	d ɪ s k ʌ v ɚ d
d ɪ s k w a l ɪ f aɪ	d ɪ s k w a l ɪ f aɪ d
d ɪ s l a ʤ	d ɪ s l a ʤ d
d ɪ s m æ n t ə l	d ɪ s m æ n t ə l d
d ɪ s m eɪ	d ɪ s m eɪ d
d ɪ s m ɛ m b ɚ	d ɪ s m ɛ m b ɚ d
d ɪ s oʊ n	d ɪ s oʊ n d
d ɪ s oʊ r d ɚ	d ɪ s oʊ r d ɚ d
d ɪ s oʊ r ɡ ə n aɪ z	d ɪ s oʊ r ɡ ə n aɪ z d
d ɪ s p aɪ z	d ɪ s p aɪ z d
d ɪ s p eɪ r	d ɪ s p eɪ r d
d ɪ s p eɪ r ɪ ʤ	d ɪ s p eɪ r ɪ ʤ d
d ɪ s p ɛ l	d ɪ s p ɛ l d
d ɪ s p l eɪ	d ɪ s p l eɪ d
d ɪ s p l i z	d ɪ s p l i z d
d ɪ s p oʊ z	d ɪ s p oʊ z d
d ɪ s p ɔɪ l	d ɪ s p ɔɪ l d
d ɪ s p r u v	d ɪ s p r u v d
d ɪ s s æ t ɪ s f aɪ	d ɪ s s æ t ɪ s f aɪ d
d ɪ s t ɚ b	d ɪ s t ɚ b d
d ɪ s t ɪ l	d ɪ s t ɪ l d
d ɪ s t r ɔɪ	d ɪ s t r ɔɪ d
d ɪ s ʧ a r ʤ	d ɪ s ʧ a r ʤ d
d ɪ t eɪ n	d ɪ t eɪ n d
d ɪ t ɚ	d ɪ t ɚ d
d ɪ t ɚ m ɪ n	d ɪ t ɚ m ɪ n d
d ɪ v aɪ n	d ɪ v aɪ n d
d ɪ v aɪ z	d ɪ v aɪ z d
d ɪ v aʊ ɚ	d ɪ v aʊ ɚ d
d ɪ v ɚ s ɪ f aɪ	d ɪ v ɚ s ɪ f aɪ d
d ɪ z a l v	d ɪ z a l v d
d ɪ z aɪ ɚ	d ɪ z aɪ ɚ d
d ɪ z aɪ n	d ɪ z aɪ n d
d ɪ z ɚ v	d ɪ z ɚ v d
d ɪ z i	d ɪ z i d
d oʊ z	d oʊ z d
d ɔ b	d ɔ b d
d ɔ d ə l	d ɔ d ə l d
d ɔ n	d ɔ n d
d r æ ɡ	d r æ ɡ d
d r æ m ə t aɪ z	d r æ m ə t aɪ z d
d r aɪ	d r aɪ d
d r aʊ n	d r aʊ n d
d r aʊ z	d r aʊ z d
d r eɪ n	d r eɪ n d
d r ɛ ʤ	d r ɛ ʤ d
d r ɪ b ə l	d r ɪ b ə l d
d r ɪ l	d r ɪ l d
d r oʊ n	d r oʊ n d
d r ɔ l	d r ɔ l d
d r u l	d r u l d
d r ʌ ɡ	d r ʌ ɡ d
d r ʌ m	d r ʌ m d
d u d ə l	d u d ə l d
d u ə l	d u ə l d
d u m	d u m d
d ʌ b	d ʌ b d
d ʌ b ə l	d ʌ b ə l d
d ʌ l	d ʌ l d
d w ɛ l	d w ɛ l d
d w ɪ n d ə l	d w ɪ n d ə l d
ʤ a ɡ	ʤ a ɡ d
ʤ a ɡ ə l	ʤ a ɡ ə l d
ʤ a k i	ʤ a k i d
ʤ a r	ʤ a r d
ʤ a s ə l	ʤ a s ə l d
ʤ æ b	ʤ æ b d
ʤ æ b ɚ	ʤ æ b ɚ d
ʤ æ m	ʤ æ m d
ʤ æ ŋ ɡ ə l	ʤ æ ŋ ɡ ə l d
ʤ eɪ l	ʤ eɪ l d
ʤ ɛ n ə r ə l aɪ z	ʤ ɛ n ə r ə l aɪ z d
ʤ ɛ p ɚ d aɪ z	ʤ ɛ p ɚ d aɪ z d
ʤ ɛ s ʧ ɚ	ʤ ɛ s ʧ ɚ d
ʤ ɛ t ɪ s ə n	ʤ ɛ t ɪ s ə n d
ʤ ɚ n i	ʤ ɚ n i d
ʤ i r	ʤ i r d
ʤ ɪ b	ʤ ɪ b d
ʤ ɪ ɡ	ʤ ɪ ɡ d
ʤ ɪ ɡ ə l	ʤ ɪ ɡ ə l d
ʤ ɪ ŋ ɡ ə l	ʤ ɪ ŋ ɡ ə l d
ʤ ɔɪ n	ʤ ɔɪ n d
ʤ ʌ ʤ	ʤ ʌ ʤ d
ʤ ʌ ɡ ə l	ʤ ʌ ɡ ə l d
ʤ ʌ k s t ə p oʊ z	ʤ ʌ k s t ə p oʊ z d
ʤ ʌ m b ə l	ʤ ʌ m b ə l d
ʤ ʌ s t ə f aɪ	ʤ ʌ s t ə f aɪ d
eɪ ʤ	eɪ ʤ d
eɪ l	eɪ l d
eɪ m	eɪ m d
eɪ r	eɪ r d
eɪ r	eɪ r d
ə b æ n d ə n	ə b æ n d ə n d
ə b h oʊ r	ə b h oʊ r d
ə b j u z	ə b j u z d
ə b l aɪ ʤ	ə b l aɪ ʤ d
ə b r ɪ ʤ	ə b r ɪ ʤ d
ə b s k j u r	ə b s k j u r d
ə b s t eɪ n	ə b s t eɪ n d
ə b t eɪ n	ə b t eɪ n d
ə b z a l v	ə b z a l v d
ə b z ɚ v	ə b z ɚ v d
ə b z oʊ r b	ə b z oʊ r b d
ə d m aɪ r	ə d m aɪ r d
ə d m ɪ n ə s t ɚ	ə d m ɪ n ə s t ɚ d
ə d oʊ r	ə d oʊ r d
ə d oʊ r n	ə d oʊ r n d
ə d v æ n t ɪ ʤ	ə d v æ n t ɪ ʤ d
ə d v aɪ z	ə d v aɪ z d
ə ʤ ɚ n	ə ʤ ɚ n d
ə ʤ ɔɪ n	ə ʤ ɔɪ n d
ə ʤ u r	ə ʤ u r d
ə ʤ ʌ ʤ	ə ʤ ʌ ʤ d
ə f ɚ m	ə f ɚ m d
ə ɡ r i	ə ɡ r i d
ə k eɪ ʒ ə n	ə k eɪ ʒ ə n d
ə k ɚ	ə k ɚ d
ə k j u z	ə k j u z d
ə k l aɪ m ə t aɪ z	ə k l aɪ m ə t aɪ z d
ə k l eɪ m	ə k l eɪ m d
ə k n a l ɪ ʤ	ə k n a l ɪ ʤ d
ə k r u	ə k r u d
ə k ʌ m p ə n i	ə k ʌ m p ə n i d
ə k ʌ s t ə m	ə k ʌ s t ə m d
ə k w aɪ ɚ	ə k w aɪ ɚ d
ə l a r m	ə l a r m d
ə l aɪ	ə l aɪ d
ə l aɪ n	ə l aɪ n d
ə l aʊ	ə l aʊ d
ə l eɪ	ə l eɪ d
ə l ɛ ʤ	ə l ɛ ʤ d
ə m eɪ z	ə m eɪ z d
ə m j u z	ə m j u z d
ə n ɛ s θ ə t aɪ z	ə n ɛ s θ ə t aɪ z d
ə n ɔɪ	ə n ɔɪ d
ə n ʌ l	ə n ʌ l d
ə p a l ə ʤ aɪ z	ə p a l ə ʤ aɪ z d
ə p i l	ə p i l d
ə p i r	ə p i r d
ə p i z	ə p i z d
ə p l aɪ	ə p l aɪ d
ə p oʊ r ʃ ə n	ə p oʊ r ʃ ə n d
ə p oʊ z	ə p oʊ z d
ə p ɔ l	ə p ɔ l d
ə p r aɪ z	ə p r aɪ z d
ə p r eɪ z	ə p r eɪ z d
ə p r u v	ə p r u v d
ə r aɪ v	ə r aɪ v d
ə r aʊ z	ə r aʊ z d
ə r eɪ	ə r eɪ d
ə r eɪ n	ə r eɪ n d
ə r eɪ n ʤ	ə r eɪ n ʤ d
ə s aɪ n	ə s aɪ n d
ə s eɪ l	ə s eɪ l d
ə s ɛ m b ə l	ə s ɛ m b ə l d
ə s p aɪ ɚ	ə s p aɪ ɚ d
ə s u m	ə s u m d
ə s w eɪ ʤ	ə s w eɪ ʤ d
ə ʃ u r	ə ʃ u r d
ə t aɪ ɚ	ə t aɪ ɚ d
ə t eɪ n	ə t eɪ n d
ə t oʊ n	ə t oʊ n d
ə ʧ i v	ə ʧ i v d
ə v aʊ	ə v aʊ d
ə v eɪ l	ə v eɪ l d
ə v ɛ n ʤ	ə v ɛ n ʤ d
ə v ɚ	ə v ɚ d
ə w eɪ k ə n	ə w eɪ k ə n d
ɛ b	ɛ b d
ɛ d i	ɛ d i d
ɛ d ɪ f aɪ	ɛ d ɪ f aɪ d
ɛ ʤ	ɛ ʤ d
ɛ ɡ z u m	ɛ ɡ z u m d
ɛ k oʊ	ɛ k oʊ d
ɛ k s aɪ l	ɛ k s aɪ l d
ɛ k s aɪ z	ɛ k s aɪ z d
ɛ k s ɚ s aɪ z	ɛ k s ɚ s aɪ z d
ɛ k s h eɪ l	ɛ k s h eɪ l d
ɛ k s oʊ r s aɪ z	ɛ k s oʊ r s aɪ z d
ɛ k s r eɪ	ɛ k s r eɪ d
ɛ k s t oʊ l	ɛ k s t oʊ l d
ɛ l b oʊ	ɛ l b oʊ d
ɛ m f ə s aɪ z	ɛ m f ə s aɪ z d
ɛ m p t i	ɛ m p t i d
ɛ n ʤ ɪ n i r	ɛ n ʤ ɪ n i r d
ɛ n ɚ ʤ aɪ z	ɛ n ɚ ʤ aɪ z d
ɛ n t ɚ	ɛ n t ɚ d
ɛ n t ɚ t eɪ n	ɛ n t ɚ t eɪ n d
ɛ n v i	ɛ n v i d
ɛ s eɪ	ɛ s eɪ d
ɛ s ʧ u	ɛ s ʧ u d
ɚ b ə n aɪ z	ɚ b ə n aɪ z d
ɚ ʤ	ɚ ʤ d
ɚ n	ɚ n d
f a ð ɚ	f a ð ɚ d
f a l oʊ	f a l oʊ d
f a n d ə l	f a n d ə l d
f a r m	f a r m d
f æ ð ə m	f æ ð ə m d
f æ n	f æ n d
f æ n s i	f æ n s i d
f æ s ə n	f æ s ə n d
f æ ʃ ə n	f æ ʃ ə n d
f æ t ə n	f æ t ə n d
f aɪ ɚ	f aɪ ɚ d
f aɪ l	f aɪ l d
f aɪ n	f aɪ n d
f aɪ n ə l aɪ z	f aɪ n ə l aɪ z d
f aʊ l	f aʊ l d
f aʊ n d ɚ	f aʊ n d ɚ d
f eɪ l	f eɪ l d
f eɪ n	f eɪ n d
f eɪ r	f eɪ r d
f eɪ r i	f eɪ r i d
f eɪ r oʊ	f eɪ r oʊ d
f eɪ v ɚ	f eɪ v ɚ d
f eɪ z	f eɪ z d
f ə l eɪ	f ə l eɪ d
f ə l f ɪ l	f ə l f ɪ l d
f ə m ɪ l j ə r aɪ z	f ə m ɪ l j ə r aɪ z d
f ə t i ɡ	f ə t i ɡ d
f ɛ ð ɚ	f ɛ ð ɚ d
f ɛ l	f ɛ l d
f ɛ s t ɚ	f ɛ s t ɚ d
f ɛ s t u n	f ɛ s t u n d
f ɛ t ɚ	f ɛ t ɚ d
f ɚ	f ɚ d
f ɚ ð ɚ	f ɚ ð ɚ d
f ɚ l	f ɚ l d
f ɚ m	f ɚ m d
f ɚ oʊ	f ɚ oʊ d
f ɚ t ə l aɪ z	f ɚ t ə l aɪ z d
f i r	f i r d
f i ʧ ɚ	f i ʧ ɚ d
f ɪ d ə l	f ɪ d ə l d
f ɪ ɡ j ɚ	f ɪ ɡ j ɚ d
f ɪ l	f ɪ l d
f ɪ l m	f ɪ l m d
f ɪ l t ɚ	f ɪ l t ɚ d
f ɪ ŋ ɡ ɚ	f ɪ ŋ ɡ ɚ d
f ɪ z	f ɪ z d
f ɪ z ə l	f ɪ z ə l d
f j u ə l	f j u ə l d
f j u m	f j u m d
f j u z	f j u z d
f l a ɡ	f l a ɡ d
f l æ ɡ	f l æ ɡ d
f l æ t ə n	f l æ t ə n d
f l æ t ɚ	f l æ t ɚ d
f l aʊ ɚ	f l aʊ ɚ d
f l aʊ ɚ	f l aʊ ɚ d
f l aʊ n d ɚ	f l aʊ n d ɚ d
f l eɪ	f l eɪ d
f l eɪ l	f l eɪ l d
f l eɪ m	f l eɪ m d
f l eɪ r	f l eɪ r d
f l eɪ v ɚ	f l eɪ v ɚ d
f l ɪ k ɚ	f l ɪ k ɚ d
f l oʊ	f l oʊ d
f l oʊ r	f l oʊ r d
f l ɔ	f l ɔ d
f l ʌ s t ɚ	f l ʌ s t ɚ d
f l ʌ t ɚ	f l ʌ t ɚ d
f oʊ m	f oʊ m d
f oʊ n	f oʊ n d
f oʊ r ʤ	f oʊ r ʤ d
f oʊ r ɪ ʤ	f oʊ r ɪ ʤ d
f oʊ r k l oʊ z	f oʊ r k l oʊ z d
f oʊ r m	f oʊ r m d
f oʊ r m ə l aɪ z	f oʊ r m ə l aɪ z d
f oʊ r s t ɔ l	f oʊ r s t ɔ l d
f oʊ r ʃ æ d oʊ	f oʊ r ʃ æ d oʊ d
f oʊ r ʃ oʊ r t ə n	f oʊ r ʃ oʊ r t ə n d
f oʊ r t ɪ f aɪ	f oʊ r t ɪ f aɪ d
f oʊ r w oʊ r n	f oʊ r w oʊ r n d
f oʊ t oʊ k a p i	f oʊ t oʊ k a p i d
f ɔ l s ə f aɪ	f ɔ l s ə f aɪ d
f ɔ l t ɚ	f ɔ l t ɚ d
f ɔ n	f ɔ n d
f ɔ s ɪ l aɪ z	f ɔ s ɪ l aɪ z d
f ɔ s t ɚ	f ɔ s t ɚ d
f ɔɪ l	f ɔɪ l d
f r æ k ʧ ɚ	f r æ k ʧ ɚ d
f r aɪ	f r aɪ d
f r aɪ t ə n	f r aɪ t ə n d
f r aʊ n	f r aʊ n d
f r eɪ	f r eɪ d
f r eɪ m	f r eɪ m d
f r eɪ z	f r eɪ z d
f r ɛ ʃ ə n	f r ɛ ʃ ə n d
f r i	f r i d
f r i w i l	f r i w i l d
f r ɪ n ʤ	f r ɪ n ʤ d
f u l	f u l d
f ʌ ʤ	f ʌ ʤ d
f ʌ m b ə l	f ʌ m b ə l d
f ʌ n ə l	f ʌ n ə l d
f ʌ ŋ k ʃ ə n	f ʌ ŋ k ʃ ə n d
ɡ a b ə l	ɡ a b ə l d
ɡ a ɡ ə l	ɡ a ɡ ə l d
ɡ a r b ə l	ɡ a r b ə l d
ɡ a r d ə n	ɡ a r d ə n d
ɡ a r n ɚ	ɡ a r n ɚ d
ɡ æ b ə l	ɡ æ b ə l d
ɡ æ ð ɚ	ɡ æ ð ɚ d
ɡ æ ɡ	ɡ æ ɡ d
ɡ æ l v ə n aɪ z	ɡ æ l v ə n aɪ z d
ɡ æ m b ə l	ɡ æ m b ə l d
ɡ æ m b ə l	ɡ æ m b ə l d
ɡ aʊ ʤ	ɡ aʊ ʤ d
ɡ eɪ ʤ	ɡ eɪ ʤ d
ɡ eɪ m	ɡ eɪ m d
ɡ eɪ n	ɡ eɪ n d
ɡ eɪ r ə n t i	ɡ eɪ r ə n t i d
ɡ eɪ z	ɡ eɪ z d
ɡ ɚ d ə l	ɡ ɚ d ə l d
ɡ ɚ ɡ ə l	ɡ ɚ ɡ ə l d
ɡ i r	ɡ i r d
ɡ ɪ ɡ ə l	ɡ ɪ ɡ ə l d
ɡ l æ d ə n	ɡ l æ d ə n d
ɡ l aʊ ɚ	ɡ l aʊ ɚ d
ɡ l eɪ r	ɡ l eɪ r d
ɡ l eɪ z	ɡ l eɪ z d
ɡ l i m	ɡ l i m d
ɡ l i n	ɡ l i n d
ɡ l ɪ m ɚ	ɡ l ɪ m ɚ d
ɡ l ɪ s ə n	ɡ l ɪ s ə n d
ɡ l ɪ t ɚ	ɡ l ɪ t ɚ d
ɡ l oʊ	ɡ l oʊ d
ɡ l oʊ r ɪ f aɪ	ɡ l oʊ r ɪ f aɪ d
ɡ l u	ɡ l u d
ɡ oʊ r	ɡ oʊ r d
ɡ oʊ r ʤ	ɡ oʊ r ʤ d
ɡ ɔ l	ɡ ɔ l d
ɡ r a v ə l	ɡ r a v ə l d
ɡ r æ b	ɡ r æ b d
ɡ r æ p ə l	ɡ r æ p ə l d
ɡ r æ t ɪ f aɪ	ɡ r æ t ɪ f aɪ d
ɡ r æ v ə l	ɡ r æ v ə l d
ɡ r aʊ l	ɡ r aʊ l d
ɡ r eɪ	ɡ r eɪ d
ɡ r eɪ z	ɡ r eɪ z d
ɡ r i v	ɡ r i v d
ɡ r ɪ l	ɡ r ɪ l d
ɡ r ɪ n	ɡ r ɪ n d
ɡ r oʊ n	ɡ r oʊ n d
ɡ r u m	ɡ r u m d
ɡ r u v	ɡ r u v d
ɡ r ʌ b	ɡ r ʌ b d
ɡ r ʌ ʤ	ɡ r ʌ ʤ d
ɡ r ʌ m b ə l	ɡ r ʌ m b ə l d
ɡ ʌ f ɔ	ɡ ʌ f ɔ d
ɡ ʌ m	ɡ ʌ m d
ɡ ʌ t ɚ	ɡ ʌ t ɚ d
ɡ ʌ v ɚ n	ɡ ʌ v ɚ n d
ɡ ʌ z ə l	ɡ ʌ z ə l d
h a b ə l	h a b ə l d
h a ɡ	h a ɡ d
h a l ə d eɪ	h a l ə d eɪ d
h a l ɚ	h a l ɚ d
h a m a ʤ ə n aɪ z	h a m a ʤ ə n aɪ z d
h a r b ɚ	h a r b ɚ d
h a r d ə n	h a r d ə n d
h a r m	h a r m d
h a r m ə n aɪ z	h a r m ə n aɪ z d
h a r t ə n	h a r t ə n d
h æ ɡ ə l	h æ ɡ ə l d
h æ l oʊ	h æ l oʊ d
h æ m ɚ	h æ m ɚ d
h æ m p ɚ	h æ m p ɚ d
h æ n d ə l	h æ n d ə l d
h æ p ə n	h æ p ə n d
h æ v	h æ v d
h aɪ ɚ	h aɪ ɚ d
h aɪ t ə n	h aɪ t ə n d
h aɪ v	h aɪ v d
h aʊ l	h aʊ l d
h aʊ z	h aʊ z d
h eɪ l	h eɪ l d
h eɪ r	h eɪ r d
h eɪ r i	h eɪ r i d
h eɪ r oʊ	h eɪ r oʊ d
h eɪ s ə n	h eɪ s ə n d
h eɪ z	h eɪ z d
h ə r æ ŋ	h ə r æ ŋ d
h ɛ d l aɪ n	h ɛ d l aɪ n d
h ɛ ʤ	h ɛ ʤ d
h ɛ k ə l	h ɛ k ə l d
h ɛ k t ɚ	h ɛ k t ɚ d
h ɛ m	h ɛ m d
h ɚ i	h ɚ i d
h ɚ l	h ɚ l d
h ɚ t ə l	h ɚ t ə l d
h i l	h i l d
h i l	h i l d
h i v	h i v d
h ɪ n d ɚ	h ɪ n d ɚ d
h ɪ n ʤ	h ɪ n ʤ d
h ɪ p n ə t aɪ z	h ɪ p n ə t aɪ z d
h j u	h j u d
h j u m ə n aɪ z	h j u m ə n aɪ z d
h j u m ɚ	h j u m ɚ d
h oʊ	h oʊ d
h oʊ l	h oʊ l d
h oʊ m	h oʊ m d
h oʊ n	h oʊ n d
h oʊ r ɪ f aɪ	h oʊ r ɪ f aɪ d
h oʊ z	h oʊ z d
h ɔ l	h ɔ l d
h ɔ s p ɪ t ə l aɪ z	h ɔ s p ɪ t ə l aɪ z d
h ʌ d ə l	h ʌ d ə l d
h ʌ ɡ	h ʌ ɡ d
h ʌ m	h ʌ m d
h ʌ m b ə l	h ʌ m b ə l d
h ʌ ŋ ɡ ɚ	h ʌ ŋ ɡ ɚ d
h ʌ s ə l	h ʌ s ə l d
h ʌ v ɚ	h ʌ v ɚ d
i k w ə l	i k w ə l d
i k w ə l aɪ z	i k w ə l aɪ z d
i z	i z d
ɪ ɡ n oʊ r	ɪ ɡ n oʊ r d
ɪ ɡ z æ m ɪ n	ɪ ɡ z æ m ɪ n d
ɪ ɡ z ɛ m p l ə f aɪ	ɪ ɡ z ɛ m p l ə f aɪ d
ɪ k a n ə m aɪ z	ɪ k a n ə m aɪ z d
ɪ k s ɛ l	ɪ k s ɛ l d
ɪ k s k j u z	ɪ k s k j u z d
ɪ k s k l eɪ m	ɪ k s k l eɪ m d
ɪ k s p aɪ ɚ	ɪ k s p aɪ ɚ d
ɪ k s p ɛ l	ɪ k s p ɛ l d
ɪ k s p l eɪ n	ɪ k s p l eɪ n d
ɪ k s p l oʊ r	ɪ k s p l oʊ r d
ɪ k s p oʊ z	ɪ k s p oʊ z d
ɪ k s p ʌ n ʤ	ɪ k s p ʌ n ʤ d
ɪ k s t ɚ n ə l aɪ z	ɪ k s t ɚ n ə l aɪ z d
ɪ k s ʧ eɪ n ʤ	ɪ k s ʧ eɪ n ʤ d
ɪ l ɛ k t r ɪ f aɪ	ɪ l ɛ k t r ɪ f aɪ d
ɪ m æ ʤ ə n	ɪ m æ ʤ ə n d
ɪ m b a d i	ɪ m b a d i d
ɪ m b a m	ɪ m b a m d
ɪ m b aɪ b	ɪ m b aɪ b d
ɪ m b ɪ t ɚ	ɪ m b ɪ t ɚ d
ɪ m b l eɪ z ə n	ɪ m b l eɪ z ə n d
ɪ m b oʊ l d ə n	ɪ m b oʊ l d ə n d
ɪ m b r ɔɪ d ɚ	ɪ m b r ɔɪ d ɚ d
ɪ m b r ɔɪ l	ɪ m b r ɔɪ l d
ɪ m ɚ ʤ	ɪ m ɚ ʤ d
ɪ m j ʊ n aɪ z	ɪ m j ʊ n aɪ z d
ɪ m oʊ b ɪ l aɪ z	ɪ m oʊ b ɪ l aɪ z d
ɪ m oʊ r t ə l aɪ z	ɪ m oʊ r t ə l aɪ z d
ɪ m p aʊ ɚ	ɪ m p aʊ ɚ d
ɪ m p eɪ l	ɪ m p eɪ l d
ɪ m p eɪ r	ɪ m p eɪ r d
ɪ m p eɪ r ə l	ɪ m p eɪ r ə l d
ɪ m p ɛ l	ɪ m p ɛ l d
ɪ m p j u n	ɪ m p j u n d
ɪ m p l aɪ	ɪ m p l aɪ d
ɪ m p l oʊ r	ɪ m p l oʊ r d
ɪ m p l ɔɪ	ɪ m p l ɔɪ d
ɪ m p oʊ z	ɪ m p oʊ z d
ɪ m p r ə v aɪ z	ɪ m p r ə v aɪ z d
ɪ m p r ɪ z ə n	ɪ m p r ɪ z ə n d
ɪ m p r u v	ɪ m p r u v d
ɪ n æ m ə l	ɪ n æ m ə l d
ɪ n d aʊ	ɪ n d aʊ d
ɪ n d eɪ n ʤ ɚ	ɪ n d eɪ n ʤ ɚ d
ɪ n d ɛ v ɚ	ɪ n d ɛ v ɚ d
ɪ n d ɪ v ɪ ʤ u ə l aɪ z	ɪ n d ɪ v ɪ ʤ u ə l aɪ z d
ɪ n d u r	ɪ n d u r d
ɪ n d ʌ l ʤ	ɪ n d ʌ l ʤ d
ɪ n d ʌ s t r i ə l aɪ z	ɪ n d ʌ s t r i ə l aɪ z d
ɪ n ʤ ɛ n d ɚ	ɪ n ʤ ɛ n d ɚ d
ɪ n ʤ ɚ	ɪ n ʤ ɚ d
ɪ n ʤ ɔɪ	ɪ n ʤ ɔɪ d
ɪ n ʤ ɔɪ n	ɪ n ʤ ɔɪ n d
ɪ n eɪ b ə l	ɪ n eɪ b ə l d
ɪ n f ɚ	ɪ n f ɚ d
ɪ n f i b ə l	ɪ n f i b ə l d
ɪ n f j u z	ɪ n f j u z d
ɪ n f l eɪ m	ɪ n f l eɪ m d
ɪ n f oʊ r m	ɪ n f oʊ r m d
ɪ n f r ɪ n ʤ	ɪ n f r ɪ n ʤ d
ɪ n ɡ eɪ ʤ	ɪ n ɡ eɪ ʤ d
ɪ n ɡ r eɪ v	ɪ n ɡ r eɪ v d
ɪ n h eɪ l	ɪ n h eɪ l d
ɪ n ɪ ʃ ə l	ɪ n ɪ ʃ ə l d
ɪ n k aʊ n t ɚ	ɪ n k aʊ n t ɚ d
ɪ n k ɚ	ɪ n k ɚ d
ɪ n k ɚ ɪ ʤ	ɪ n k ɚ ɪ ʤ d
ɪ n k l aɪ n	ɪ n k l aɪ n d
ɪ n k l oʊ z	ɪ n k l oʊ z d
ɪ n k ʌ m b ɚ	ɪ n k ʌ m b ɚ d
ɪ n k w aɪ ɚ	ɪ n k w aɪ ɚ d
ɪ n l a r ʤ	ɪ n l a r ʤ d
ɪ n l aɪ t ə n	ɪ n l aɪ t ə n d
ɪ n l aɪ v ə n	ɪ n l aɪ v ə n d
ɪ n l eɪ	ɪ n l eɪ d
ɪ n oʊ b ə l	ɪ n oʊ b ə l d
ɪ n r æ p ʧ ɚ	ɪ n r æ p ʧ ɚ d
ɪ n r eɪ ʤ	ɪ n r eɪ ʤ d
ɪ n r oʊ l	ɪ n r oʊ l d
ɪ n s aɪ z	ɪ n s aɪ z d
ɪ n s ɚ k ə l	ɪ n s ɚ k ə l d
ɪ n s k r aɪ b	ɪ n s k r aɪ b d
ɪ n s l eɪ v	ɪ n s l eɪ v d
ɪ n s n eɪ r	ɪ n s n eɪ r d
ɪ n s p aɪ ɚ	ɪ n s p aɪ ɚ d
ɪ n s t ɪ l	ɪ n s t ɪ l d
ɪ n s t ɪ t u ʃ ə n ə l aɪ z	ɪ n s t ɪ t u ʃ ə n ə l aɪ z d
ɪ n s t ɔ l	ɪ n s t ɔ l d
ɪ n s u	ɪ n s u d
ɪ n ʃ r aɪ n	ɪ n ʃ r aɪ n d
ɪ n ʃ u r	ɪ n ʃ u r d
ɪ n ʃ u r	ɪ n ʃ u r d
ɪ n t æ ŋ ɡ ə l	ɪ n t æ ŋ ɡ ə l d
ɪ n t aɪ t ə l	ɪ n t aɪ t ə l d
ɪ n t eɪ l	ɪ n t eɪ l d
ɪ n t ɛ n s ɪ f aɪ	ɪ n t ɛ n s ɪ f aɪ d
ɪ n t ɚ	ɪ n t ɚ d
ɪ n t ɚ m ɪ ŋ ɡ ə l	ɪ n t ɚ m ɪ ŋ ɡ ə l d
ɪ n t ɚ n	ɪ n t ɚ n d
ɪ n t ɚ n æ ʃ ə n ə l aɪ z	ɪ n t ɚ n æ ʃ ə n ə l aɪ z d
ɪ n t ɚ n ə l aɪ z	ɪ n t ɚ n ə l aɪ z d
ɪ n t ɚ p oʊ z	ɪ n t ɚ p oʊ z d
ɪ n t ɚ r f i r	ɪ n t ɚ r f i r d
ɪ n t ɚ t w aɪ n	ɪ n t ɚ t w aɪ n d
ɪ n t ɚ v i n	ɪ n t ɚ v i n d
ɪ n t ɚ v j u	ɪ n t ɚ v j u d
ɪ n t oʊ n	ɪ n t oʊ n d
ɪ n t r i ɡ	ɪ n t r i ɡ d
ɪ n t w aɪ n	ɪ n t w aɪ n d
ɪ n v a l v	ɪ n v a l v d
ɪ n v ɪ z ɪ ʤ	ɪ n v ɪ z ɪ ʤ d
ɪ n v ɪ ʒ ə n	ɪ n v ɪ ʒ ə n d
ɪ n θ r ɔ l	ɪ n θ r ɔ l d
ɪ n θ u z	ɪ n θ u z d
ɪ p ɪ t ə m aɪ z	ɪ p ɪ t ə m aɪ z d
ɪ s p aʊ z	ɪ s p aʊ z d
ɪ s t i m	ɪ s t i m d
ɪ s t r eɪ n ʤ	ɪ s t r eɪ n ʤ d
ɪ ʃ u	ɪ ʃ u d
ɪ v a l v	ɪ v a l v d
j ɛ l	j ɛ l d
j ɛ l oʊ	j ɛ l oʊ d
j ɚ n	j ɚ n d
j ɔ n	j ɔ n d
j u l ə ʤ aɪ z	j u l ə ʤ aɪ z d
j u n ɪ f aɪ	j u n ɪ f aɪ d
j u n j ə n aɪ z	j u n j ə n aɪ z d
j u t ə l aɪ z	j u t ə l aɪ z d
j u z	j u z d
k a b ə l	k a b ə l d
k a d ə l	k a d ə l d
k a d ɪ f aɪ	k a d ɪ f aɪ d
k a l ə n aɪ z	k a l ə n aɪ z d
k a m	k a m d
k a m ə n d i r	k a m ə n d i r d
k a m p a r t m ɛ n t ə l aɪ z	k a m p a r t m ɛ n t ə l aɪ z d
k a m p r ə m aɪ z	k a m p r ə m aɪ z d
k a n	k a n d
k a n ʤ ɚ	k a n ʤ ɚ d
k a n t r ə v i n	k a n t r ə v i n d
k a ŋ k ɚ	k a ŋ k ɚ d
k a p i	k a p i d
k a r v	k a r v d
k æ ʤ	k æ ʤ d
k æ k ə l	k æ k ə l d
k æ m ə f l a ʒ	k æ m ə f l a ʒ d
k æ m p eɪ n	k æ m p eɪ n d
k æ n ə n aɪ z	k æ n ə n aɪ z d
k æ n s ə l	k æ n s ə l d
k æ n t ɚ	k æ n t ɚ d
k æ p ɪ t ə l aɪ z	k æ p ɪ t ə l aɪ z d
k æ p s aɪ z	k æ p s aɪ z d
k æ p t ɪ n	k æ p t ɪ n d
k æ p ʧ ɚ	k æ p ʧ ɚ d
k æ t ə ɡ ɚ aɪ z	k æ t ə ɡ ɚ aɪ z d
k æ t ə l ɔ ɡ	k æ t ə l ɔ ɡ d
k æ v	k æ v d
k aʊ	k aʊ d
k aʊ ɚ	k aʊ ɚ d
k aʊ n s ə l	k aʊ n s ə l d
k aʊ n t ɚ	k aʊ n t ɚ d
k aʊ n t ɚ v eɪ l	k aʊ n t ɚ v eɪ l d
k eɪ b ə l	k eɪ b ə l d
k eɪ ʤ	k eɪ ʤ d
k eɪ n	k eɪ n d
k eɪ oʊ	k eɪ oʊ d
k eɪ p ɚ	k eɪ p ɚ d
k eɪ r	k eɪ r d
k eɪ r i	k eɪ r i d
k eɪ r ɪ k ə ʧ ɚ	k eɪ r ɪ k ə ʧ ɚ d
k eɪ r ɪ k t ə r aɪ z	k eɪ r ɪ k t ə r aɪ z d
k eɪ t ɚ	k eɪ t ɚ d
k ə ʤ oʊ l	k ə ʤ oʊ l d
k ə k u n	k ə k u n d
k ə l ɛ k t ɪ v aɪ z	k ə l ɛ k t ɪ v aɪ z d
k ə m b aɪ n	k ə m b aɪ n d
k ə m ɚ ʃ ə l aɪ z	k ə m ɚ ʃ ə l aɪ z d
k ə m ɪ ʃ ə n	k ə m ɪ ʃ ə n d
k ə m j u n	k ə m j u n d
k ə m p aɪ l	k ə m p aɪ l d
k ə m p eɪ r	k ə m p eɪ r d
k ə m p ɛ l	k ə m p ɛ l d
k ə m p j u t ɚ aɪ z	k ə m p j u t ɚ aɪ z d
k ə m p l aɪ	k ə m p l aɪ d
k ə m p l eɪ n	k ə m p l eɪ n d
k ə m p oʊ z	k ə m p oʊ z d
k ə m p r aɪ z	k ə m p r aɪ z d
k ə n aɪ v	k ə n aɪ v d
k ə n d ɛ m	k ə n d ɛ m d
k ə n d ɪ ʃ ə n	k ə n d ɪ ʃ ə n d
k ə n d oʊ n	k ə n d oʊ n d
k ə n ʤ ɛ k ʧ ɚ	k ə n ʤ ɛ k ʧ ɚ d
k ə n ʤ i l	k ə n ʤ i l d
k ə n f aɪ n	k ə n f aɪ n d
k ə n f ɚ	k ə n f ɚ d
k ə n f ɚ m	k ə n f ɚ m d
k ə n f j u z	k ə n f j u z d
k ə n f oʊ r m	k ə n f oʊ r m d
k ə n k ɚ	k ə n k ɚ d
k ə n s aɪ n	k ə n s aɪ n d
k ə n s ɚ n	k ə n s ɚ n d
k ə n s ɚ v	k ə n s ɚ v d
k ə n s i l	k ə n s i l d
k ə n s i v	k ə n s i v d
k ə n s ɪ d ɚ	k ə n s ɪ d ɚ d
k ə n s oʊ l	k ə n s oʊ l d
k ə n s p aɪ ɚ	k ə n s p aɪ ɚ d
k ə n s t r eɪ n	k ə n s t r eɪ n d
k ə n s t r u	k ə n s t r u d
k ə n s u m	k ə n s u m d
k ə n t eɪ n	k ə n t eɪ n d
k ə n t ɪ n j u	k ə n t ɪ n j u d
k ə n t r aɪ v	k ə n t r aɪ v d
k ə n t r oʊ l	k ə n t r oʊ l d
k ə n v eɪ	k ə n v eɪ d
k ə n v ɚ ʤ	k ə n v ɚ ʤ d
k ə n v i n	k ə n v i n d
k ə p eɪ r ɪ s ə n	k ə p eɪ r ɪ s ə n d
k ə r aʊ z	k ə r aʊ z d
k ə r i n	k ə r i n d
k ə r i r	k ə r i r d
k ɚ b	k ɚ b d
k ɚ d ə l	k ɚ d ə l d
k ɚ i	k ɚ i d
k ɚ l	k ɚ l d
k ɚ t eɪ l	k ɚ t eɪ l d
k ɚ t ə n	k ɚ t ə n d
k ɚ t s i	k ɚ t s i d
k ɚ v	k ɚ v d
k i	k i d
k i n	k i n d
k ɪ l	k ɪ l d
k ɪ n d ə l	k ɪ n d ə l d
k j u	k j u d
k j u b	k j u b d
k j u r	k j u r d
k l a b ɚ	k l a b ɚ d
k l a ɡ	k l a ɡ d
k l æ m b ɚ	k l æ m b ɚ d
k l æ m ɚ	k l æ m ɚ d
k l æ ŋ	k l æ ŋ d
k l æ s ɪ f aɪ	k l æ s ɪ f aɪ d
k l æ t ɚ	k l æ t ɚ d
k l aɪ m	k l aɪ m d
k l aʊ n	k l aʊ n d
k l eɪ m	k l eɪ m d
k l eɪ r ɪ f aɪ	k l eɪ r ɪ f aɪ d
k l ɛ n z	k l ɛ n z d
k l i n	k l i n d
k l i r	k l i r d
k l i v	k l i v d
k l oʊ ð	k l oʊ ð d
k l oʊ z	k l oʊ z d
k l ɔ	k l ɔ d
k l ɔɪ	k l ɔɪ d
k l ɔɪ s t ɚ	k l ɔɪ s t ɚ d
k l ʌ b	k l ʌ b d
k l ʌ s t ɚ	k l ʌ s t ɚ d
k l ʌ t ɚ	k l ʌ t ɚ d
k oʊ l	k oʊ l d
k oʊ m	k oʊ m d
k oʊ r n	k oʊ r n d
k oʊ r n ɚ	k oʊ r n ɚ d
k oʊ r s ə n	k oʊ r s ə n d
k ɔ	k ɔ d
k ɔ l	k ɔ l d
k ɔ ʃ ə n	k ɔ ʃ ə n d
k ɔ z	k ɔ z d
k ɔɪ l	k ɔɪ l d
k ɔɪ n	k ɔɪ n d
k r a n ɪ k ə l	k r a n ɪ k ə l d
k r æ k ə l	k r æ k ə l d
k r æ m	k r æ m d
k r aɪ	k r aɪ d
k r aʊ n	k r aʊ n d
k r eɪ d ə l	k r eɪ d ə l d
k r eɪ n	k r eɪ n d
k r eɪ v	k r eɪ v d
k r eɪ z	k r eɪ z d
k r i m	k r i m d
k r ɪ n ʤ	k r ɪ n ʤ d
k r ɪ ŋ k ə l	k r ɪ ŋ k ə l d
k r ɪ p ə l	k r ɪ p ə l d
k r ɪ s ə n	k r ɪ s ə n d
k r ɪ s t ə l aɪ z	k r ɪ s t ə l aɪ z d
k r ɪ t ɪ s aɪ z	k r ɪ t ɪ s aɪ z d
k r oʊ	k r oʊ d
k r oʊ ʃ eɪ	k r oʊ ʃ eɪ d
k r ɔ l	k r ɔ l d
k r ɔ s ɪ ɡ z æ m ɪ n	k r ɔ s ɪ ɡ z æ m ɪ n d
k r u n	k r u n d
k r u s ɪ f aɪ	k r u s ɪ f aɪ d
k r u z	k r u z d
k r ʌ m b ə l	k r ʌ m b ə l d
k r ʌ m p ə l	k r ʌ m p ə l d
k u	k u d
k u l	k u l d
k ʊ ʃ ə n	k ʊ ʃ ə n d
k ʌ d ə l	k ʌ d ə l d
k ʌ l	k ʌ l d
k ʌ l ɚ	k ʌ l ɚ d
k ʌ p ə l	k ʌ p ə l d
k ʌ v ɚ	k ʌ v ɚ d
k w a d r ʊ p ə l	k w a d r ʊ p ə l d
k w a l ə f aɪ	k w a l ə f aɪ d
k w a n t ɪ f aɪ	k w a n t ɪ f aɪ d
k w eɪ v ɚ	k w eɪ v ɚ d
k w ɛ l	k w ɛ l d
k w ɛ s ʧ ə n	k w ɛ s ʧ ə n d
k w i r i	k w i r i d
k w ɪ b ə l	k w ɪ b ə l d
k w ɪ k ə n	k w ɪ k ə n d
k w ɪ v ɚ	k w ɪ v ɚ d
k w ɪ z	k w ɪ z d
k w oʊ r ə l	k w oʊ r ə l d
k w oʊ r i	k w oʊ r i d
k w oʊ r t ɚ	k w oʊ r t ɚ d
l a b	l a b d
l a b i	l a b i d
l a ð ɚ	l a ð ɚ d
l a ʤ	l a ʤ d
l a l	l a l d
l æ ɡ	l æ ɡ d
l æ k ɚ	l æ k ɚ d
l æ m	l æ m d
l æ m p u n	l æ m p u n d
l aɪ m	l aɪ m d
l aɪ n	l aɪ n d
l aɪ t ə n	l aɪ t ə n d
l aʊ n ʤ	l aʊ n ʤ d
l eɪ	l eɪ d
l eɪ b ə l	l eɪ b ə l d
l eɪ b ɚ	l eɪ b ɚ d
l eɪ d ə l	l eɪ d ə l d
l eɪ ɚ	l eɪ ɚ d
l eɪ z	l eɪ z d
l ɛ ɡ	l ɛ ɡ d
l ɛ k ʧ ɚ	l ɛ k ʧ ɚ d
l ɛ ŋ θ ə n	l ɛ ŋ θ ə n d
l ɛ s ə n	l ɛ s ə n d
l ɛ v ə l	l ɛ v ə l d
l ɛ v ə n	l ɛ v ə n d
l ɛ v ɚ	l ɛ v ɚ d
l ɛ v i	l ɛ v i d
l ɚ n	l ɚ n d
l i eɪ z	l i eɪ z d
l i ɡ ə l aɪ z	l i ɡ ə l aɪ z d
l i n	l i n d
l i r	l i r d
l ɪ b ɚ ə l aɪ z	l ɪ b ɚ ə l aɪ z d
l ɪ ʤ ɪ t ɪ m aɪ z	l ɪ ʤ ɪ t ɪ m aɪ z d
l ɪ m b ɚ	l ɪ m b ɚ d
l ɪ ŋ ɡ ɚ	l ɪ ŋ ɡ ɚ d
l ɪ s ə n	l ɪ s ə n d
l ɪ t ɚ	l ɪ t ɚ d
l ɪ v	l ɪ v d
l oʊ	l oʊ d
l oʊ ð	l oʊ ð d
l oʊ ɚ	l oʊ ɚ d
l oʊ k ə l aɪ z	l oʊ k ə l aɪ z d
l oʊ n	l oʊ n d
l ɔ ɡ	l ɔ ɡ d
l ɔ n d ɚ	l ɔ n d ɚ d
l ɔ ŋ	l ɔ ŋ d
l ɔɪ t ɚ	l ɔɪ t ɚ d
l u m	l u m d
l u r	l u r d
l u s ə n	l u s ə n d
l ʌ ɡ	l ʌ ɡ d
l ʌ l	l ʌ l d
l ʌ m b ɚ	l ʌ m b ɚ d
l ʌ n ʤ	l ʌ n ʤ d
l ʌ v	l ʌ v d
m a b	m a b d
m a d ə f aɪ	m a d ə f aɪ d
m a d ə l	m a d ə l d
m a d ɚ n aɪ z	m a d ɚ n aɪ z d
m a l ɪ f aɪ	m a l ɪ f aɪ d
m a n ɪ t ɚ	m a n ɪ t ɚ d
m a r	m a r d
m a r ʃ ə l	m a r ʃ ə l d
m a r t ɚ	m a r t ɚ d
m a r v ə l	m a r v ə l d
m a t ə l	m a t ə l d
m æ d ə n	m æ d ə n d
m æ ɡ n ɪ f aɪ	m æ ɡ n ɪ f aɪ d
m æ k s ɪ m aɪ z	m æ k s ɪ m aɪ z d
m æ l f ʌ ŋ k ʃ ə n	m æ l f ʌ ŋ k ʃ ə n d
m æ n	m æ n d
m æ n ə k ə l	m æ n ə k ə l d
m æ n h æ n d ə l	m æ n h æ n d ə l d
m æ n ɪ ʤ	m æ n ɪ ʤ d
m æ n ɪ k j ʊ r	m æ n ɪ k j ʊ r d
m æ n j ʊ f æ k ʧ ɚ	m æ n j ʊ f æ k ʧ ɚ d
m æ ŋ ɡ ə l	m æ ŋ ɡ ə l d
m æ s ə k ɚ	m æ s ə k ɚ d
m æ s t ɚ	m æ s t ɚ d
m æ t ɚ	m æ t ɚ d
m aɪ ɚ	m aɪ ɚ d
m aɪ k r oʊ f ɪ l m	m aɪ k r oʊ f ɪ l m d
m aɪ m	m aɪ m d
m aɪ n	m aɪ n d
m aʊ ð	m aʊ ð d
m eɪ l	m eɪ l d
m eɪ m	m eɪ m d
m eɪ n t eɪ n	m eɪ n t eɪ n d
m eɪ r i	m eɪ r i d
m ə l aɪ n	m ə l aɪ n d
m ə n a p ə l aɪ z	m ə n a p ə l aɪ z d
m ə n u r	m ə n u r d
m ə n u v ɚ	m ə n u v ɚ d
m ə r u n	m ə r u n d
m ə s a ʒ	m ə s a ʒ d
m ə ʃ i n	m ə ʃ i n d
m ə t i r i ə l aɪ z	m ə t i r i ə l aɪ z d
m ə t ʃ u r	m ə t ʃ u r d
m ɛ d ə l	m ɛ d ə l d
m ɛ k ə n aɪ z	m ɛ k ə n aɪ z d
m ɛ l oʊ	m ɛ l oʊ d
m ɛ m ə r aɪ z	m ɛ m ə r aɪ z d
m ɛ n ʧ ə n	m ɛ n ʧ ə n d
m ɛ t ə m oʊ r f oʊ z	m ɛ t ə m oʊ r f oʊ z d
m ɛ z m ə r aɪ z	m ɛ z m ə r aɪ z d
m ɛ ʒ ɚ	m ɛ ʒ ɚ d
m ɚ d ɚ	m ɚ d ɚ d
m ɚ ʤ	m ɚ ʤ d
m ɚ m ɚ	m ɚ m ɚ d
m ɚ ʧ ə n d aɪ z	m ɚ ʧ ə n d aɪ z d
m i æ n d ɚ	m i æ n d ɚ d
m i r ɚ	m i r ɚ d
m ɪ l	m ɪ l d
m ɪ n ɪ m aɪ z	m ɪ n ɪ m aɪ z d
m ɪ ŋ ɡ ə l	m ɪ ŋ ɡ ə l d
m ɪ s b ɪ h eɪ v	m ɪ s b ɪ h eɪ v d
m ɪ s ʤ ʌ ʤ	m ɪ s ʤ ʌ ʤ d
m ɪ s f aɪ ɚ	m ɪ s f aɪ ɚ d
m ɪ s j u z	m ɪ s j u z d
m ɪ s k eɪ r i	m ɪ s k eɪ r i d
m ɪ s k ə n s i v	m ɪ s k ə n s i v d
m ɪ s l eɪ	m ɪ s l eɪ d
m ɪ s t ɪ f aɪ	m ɪ s t ɪ f aɪ d
m j u	m j u d
m j u z	m j u z d
m oʊ	m oʊ d
m oʊ b ə l aɪ z	m oʊ b ə l aɪ z d
m oʊ l d ɚ	m oʊ l d ɚ d
m oʊ n	m oʊ n d
m oʊ r	m oʊ r d
m oʊ r ə l aɪ z	m oʊ r ə l aɪ z d
m oʊ r ɡ ɪ ʤ	m oʊ r ɡ ɪ ʤ d
m oʊ r n	m oʊ r n d
m oʊ r t ɚ	m oʊ r t ɚ d
m oʊ r t ɪ f aɪ	m oʊ r t ɪ f aɪ d
m oʊ ʃ ə n	m oʊ ʃ ə n d
m oʊ t ə r aɪ z	m oʊ t ə r aɪ z d
m oʊ t ɚ	m oʊ t ɚ d
m ɔ l	m ɔ l d
m ɔɪ s ə n	m ɔɪ s ə n d
m u	m u d
m u v	m u v d
m ʌ d ə l	m ʌ d ə l d
m ʌ ð ɚ	m ʌ ð ɚ d
m ʌ d i	m ʌ d i d
m ʌ f ə l	m ʌ f ə l d
m ʌ ɡ	m ʌ ɡ d
m ʌ l	m ʌ l d
m ʌ l t ɪ p l aɪ	m ʌ l t ɪ p l aɪ d
m ʌ m b ə l	m ʌ m b ə l d
m ʌ m ɪ f aɪ	m ʌ m ɪ f aɪ d
m ʌ s t ɚ	m ʌ s t ɚ d
m ʌ ʃ r u m	m ʌ ʃ r u m d
m ʌ t ɚ	m ʌ t ɚ d
m ʌ z ə l	m ʌ z ə l d
n æ b	n æ b d
n æ ɡ	n æ ɡ d
n æ ʃ ə n ə l aɪ z	n æ ʃ ə n ə l aɪ z d
n æ ʧ ɚ ə l aɪ z	n æ ʧ ɚ ə l aɪ z d
n eɪ l	n eɪ l d
n eɪ m	n eɪ m d
n eɪ r oʊ	n eɪ r oʊ d
n ɛ s ə l	n ɛ s ə l d
n ɛ t ə l	n ɛ t ə l d
n ɚ ʧ ɚ	n ɚ ʧ ɚ d
n ɚ v	n ɚ v d
n i d ə l	n i d ə l d
n i l	n i l d
n i r	n i r d
n ɪ b ə l	n ɪ b ə l d
n ɪ ɡ ə l	n ɪ ɡ ə l d
n ɪ k n eɪ m	n ɪ k n eɪ m d
n oʊ t ɪ f aɪ	n oʊ t ɪ f aɪ d
n oʊ z	n oʊ z d
n ɔ	n ɔ d
n u t ɚ	n u t ɚ d
n u t r ə l aɪ z	n u t r ə l aɪ z d
n ʌ ʤ	n ʌ ʤ d
n ʌ l ɪ f aɪ	n ʌ l ɪ f aɪ d
n ʌ m	n ʌ m d
n ʌ m b ɚ	n ʌ m b ɚ d
n ʌ z ə l	n ʌ z ə l d
oʊ	oʊ d
oʊ b eɪ	oʊ b eɪ d
oʊ n	oʊ n d
oʊ p aɪ n	oʊ p aɪ n d
oʊ p ə n	oʊ p ə n d
oʊ r d eɪ n	oʊ r d eɪ n d
oʊ r d ɚ	oʊ r d ɚ d
oʊ r f ə n	oʊ r f ə n d
oʊ r ɡ ə n aɪ z	oʊ r ɡ ə n aɪ z d
oʊ v ɚ f l oʊ	oʊ v ɚ f l oʊ d
oʊ v ɚ h ɔ l	oʊ v ɚ h ɔ l d
oʊ v ɚ l eɪ	oʊ v ɚ l eɪ d
oʊ v ɚ m æ n	oʊ v ɚ m æ n d
oʊ v ɚ ɔ	oʊ v ɚ ɔ d
oʊ v ɚ p aʊ ɚ	oʊ v ɚ p aʊ ɚ d
oʊ v ɚ p eɪ	oʊ v ɚ p eɪ d
oʊ v ɚ p l eɪ	oʊ v ɚ p l eɪ d
oʊ v ɚ r b ɚ d ə n	oʊ v ɚ r b ɚ d ə n d
oʊ v ɚ r ɪ k s p oʊ z	oʊ v ɚ r ɪ k s p oʊ z d
oʊ v ɚ r ɪ n d ʌ l ʤ	oʊ v ɚ r ɪ n d ʌ l ʤ d
oʊ v ɚ r u l	oʊ v ɚ r u l d
oʊ v ɚ s ɪ m p l ɪ f aɪ	oʊ v ɚ s ɪ m p l ɪ f aɪ d
oʊ v ɚ ʃ æ d oʊ	oʊ v ɚ ʃ æ d oʊ d
oʊ v ɚ t ɚ n	oʊ v ɚ t ɚ n d
oʊ v ɚ ʧ a r ʤ	oʊ v ɚ ʧ a r ʤ d
oʊ v ɚ w ɛ l m	oʊ v ɚ w ɛ l m d
ɔ	ɔ d
ɔ d ɪ ʃ ə n	ɔ d ɪ ʃ ə n d
ɔ f ɚ	ɔ f ɚ d
ɔ l t ɚ	ɔ l t ɚ d
ɔ s ɪ f aɪ	ɔ s ɪ f aɪ d
ɔ s t r ə s aɪ z	ɔ s t r ə s aɪ z d
ɔ θ ə r aɪ z	ɔ θ ə r aɪ z d
ɔɪ l	ɔɪ l d
p a n d ɚ	p a n d ɚ d
p a p j ʊ l ɚ aɪ z	p a p j ʊ l ɚ aɪ z d
p a r d ə n	p a r d ə n d
p a r t ɪ k j ʊ l ɚ aɪ z	p a r t ɪ k j ʊ l ɚ aɪ z d
p a r t ɪ ʃ ə n	p a r t ɪ ʃ ə n d
p a r t n ɚ	p a r t n ɚ d
p a s ʧ ɚ	p a s ʧ ɚ d
p a t ɚ	p a t ɚ d
p æ d ə l	p æ d ə l d
p æ k ɪ ʤ	p æ k ɪ ʤ d
p æ m p ɚ	p æ m p ɚ d
p æ n d ɚ	p æ n d ɚ d
p æ n ə l	p æ n ə l d
p æ s ɪ f aɪ	p æ s ɪ f aɪ d
p æ s ʧ ɚ aɪ z	p æ s ʧ ɚ aɪ z d
p æ t ɚ	p æ t ɚ d
p æ t ɚ n	p æ t ɚ n d
p aɪ ə n i r	p aɪ ə n i r d
p aɪ l	p aɪ l d
p aɪ n	p aɪ n d
p aʊ d ɚ	p aʊ d ɚ d
p aʊ ɚ	p aʊ ɚ d
p eɪ	p eɪ d
p eɪ l	p eɪ l d
p eɪ n	p eɪ n d
p eɪ p ɚ	p eɪ p ɚ d
p eɪ r	p eɪ r d
p eɪ r	p eɪ r d
p eɪ r ə d i	p eɪ r ə d i d
p eɪ r ə f r eɪ z	p eɪ r ə f r eɪ z d
p eɪ r ə l aɪ z	p eɪ r ə l aɪ z d
p eɪ r ə l ɛ l	p eɪ r ə l ɛ l d
p eɪ r i	p eɪ r i d
p eɪ t r ə n aɪ z	p eɪ t r ə n aɪ z d
p eɪ v	p eɪ v d
p ə l ɪ t ɪ s aɪ z	p ə l ɪ t ɪ s aɪ z d
p ə r oʊ l	p ə r oʊ l d
p ə r u z	p ə r u z d
p ə t ɪ ʃ ə n	p ə t ɪ ʃ ə n d
p ə t r oʊ l	p ə t r oʊ l d
p ə z ɪ ʃ ə n	p ə z ɪ ʃ ə n d
p ɛ d ə l	p ɛ d ə l d
p ɛ d ə l	p ɛ d ə l d
p ɛ ɡ	p ɛ ɡ d
p ɛ n	p ɛ n d
p ɛ n s ə l	p ɛ n s ə l d
p ɛ p ɚ	p ɛ p ɚ d
p ɛ s t ɚ	p ɛ s t ɚ d
p ɛ t r ɪ f aɪ	p ɛ t r ɪ f aɪ d
p ɚ	p ɚ d
p ɚ ʤ	p ɚ ʤ d
p ɚ ʤ ɚ	p ɚ ʤ ɚ d
p ɚ f j u m	p ɚ f j u m d
p ɚ f oʊ r m	p ɚ f oʊ r m d
p ɚ l ɔɪ n	p ɚ l ɔɪ n d
p ɚ s a n ɪ f aɪ	p ɚ s a n ɪ f aɪ d
p ɚ s ə n ə l aɪ z	p ɚ s ə n ə l aɪ z d
p ɚ s i v	p ɚ s i v d
p ɚ s ɪ v i r	p ɚ s ɪ v i r d
p ɚ s p aɪ ɚ	p ɚ s p aɪ ɚ d
p ɚ s u	p ɚ s u d
p ɚ t ɚ b	p ɚ t ɚ b d
p i	p i d
p i l	p i l d
p i l	p i l d
p i n ə l aɪ z	p i n ə l aɪ z d
p i p ə l	p i p ə l d
p i r	p i r d
p ɪ k ə l	p ɪ k ə l d
p ɪ k ʧ ɚ	p ɪ k ʧ ɚ d
p ɪ l ɪ ʤ	p ɪ l ɪ ʤ d
p ɪ n	p ɪ n d
p ɪ ŋ	p ɪ ŋ d
p ɪ t i	p ɪ t i d
p j ʊ r eɪ	p j ʊ r eɪ d
p j ʊ r ɪ f aɪ	p j ʊ r ɪ f aɪ d
p l æ n	p l æ n d
p l æ s t ɚ	p l æ s t ɚ d
p l aɪ	p l aɪ d
p l aʊ	p l aʊ d
p l eɪ	p l eɪ d
p l eɪ ɡ	p l eɪ ɡ d
p l eɪ n	p l eɪ n d
p l ɛ ʤ	p l ɛ ʤ d
p l i z	p l i z d
p l ʌ ɡ	p l ʌ ɡ d
p l ʌ m	p l ʌ m d
p l ʌ n d ɚ	p l ʌ n d ɚ d
p l ʌ n ʤ	p l ʌ n ʤ d
p oʊ l	p oʊ l d
p oʊ l	p oʊ l d
p oʊ l ə r aɪ z	p oʊ l ə r aɪ z d
p oʊ r	p oʊ r d
p oʊ r t r eɪ	p oʊ r t r eɪ d
p oʊ s t p oʊ n	p oʊ s t p oʊ n d
p oʊ z	p oʊ z d
p ɔ	p ɔ d
p ɔ l	p ɔ l d
p ɔ n	p ɔ n d
p ɔ z	p ɔ z d
p ɔɪ z ə n	p ɔɪ z ə n d
p r a f ɚ	p r a f ɚ d
p r a f ɪ s aɪ	p r a f ɪ s aɪ d
p r a p ə ɡ æ n d aɪ z	p r a p ə ɡ æ n d aɪ z d
p r a p ə z ɪ ʃ ə n	p r a p ə z ɪ ʃ ə n d
p r a s p ɚ	p r a s p ɚ d
p r aɪ	p r aɪ d
p r aɪ m	p r aɪ m d
p r aɪ z	p r aɪ z d
p r aʊ l	p r aʊ l d
p r eɪ	p r eɪ d
p r eɪ	p r eɪ d
p r eɪ z	p r eɪ z d
p r ə k j u r	p r ə k j u r d
p r ə k l eɪ m	p r ə k l eɪ m d
p r ə p ɛ l	p r ə p ɛ l d
p r ə p oʊ r ʃ ə n	p r ə p oʊ r ʃ ə n d
p r ə p oʊ z	p r ə p oʊ z d
p r ɛ s ɪ ʤ	p r ɛ s ɪ ʤ d
p r ɛ ʃ ə r aɪ z	p r ɛ ʃ ə r aɪ z d
p r ɛ ʃ ɚ	p r ɛ ʃ ɚ d
p r i a k j ʊ p aɪ	p r i a k j ʊ p aɪ d
p r i d ɛ s t ɪ n	p r i d ɛ s t ɪ n d
p r i d ɪ s p oʊ z	p r i d ɪ s p oʊ z d
p r i d ɪ t ɚ m ɪ n	p r i d ɪ t ɚ m ɪ n d
p r i ə r eɪ n ʤ	p r i ə r eɪ n ʤ d
p r i n	p r i n d
p r i s ə p oʊ z	p r i s ə p oʊ z d
p r ɪ f ɚ	p r ɪ f ɚ d
p r ɪ k ə l	p r ɪ k ə l d
p r ɪ p eɪ r	p r ɪ p eɪ r d
p r ɪ s k r aɪ b	p r ɪ s k r aɪ b d
p r ɪ v eɪ l	p r ɪ v eɪ l d
p r ɪ z ɚ v	p r ɪ z ɚ v d
p r ɪ z u m	p r ɪ z u m d
p r oʊ b	p r oʊ b d
p r oʊ ɡ r æ m	p r oʊ ɡ r æ m d
p r oʊ l ɔ ŋ	p r oʊ l ɔ ŋ d
p r oʊ s k r aɪ b	p r oʊ s k r aɪ b d
p r ɔ s ə l ɪ t aɪ z	p r ɔ s ə l ɪ t aɪ z d
p r u n	p r u n d
p r u v	p r u v d
p u l	p u l d
p ʊ l	p ʊ l d
p ʌ b l ə s aɪ z	p ʌ b l ə s aɪ z d
p ʌ d ə l	p ʌ d ə l d
p ʌ k ɚ	p ʌ k ɚ d
p ʌ l v ə r aɪ z	p ʌ l v ə r aɪ z d
p ʌ m ə l	p ʌ m ə l d
p ʌ ŋ k ʧ ɚ	p ʌ ŋ k ʧ ɚ d
p ʌ z ə l	p ʌ z ə l d
r a b	r a b d
r a n d ɪ v u	r a n d ɪ v u d
r æ d ɪ k ə l aɪ z	r æ d ɪ k ə l aɪ z d
r æ l i	r æ l i d
r æ m	r æ m d
r æ m b ə l	r æ m b ə l d
r æ m p eɪ ʤ	r æ m p eɪ ʤ d
r æ ŋ ɡ ə l	r æ ŋ ɡ ə l d
r æ ŋ k ə l	r æ ŋ k ə l d
r æ ʃ ə n	r æ ʃ ə n d
r æ ʃ ə n ə l aɪ z	r æ ʃ ə n ə l aɪ z d
r æ t ə l	r æ t ə l d
r æ t ɪ f aɪ	r æ t ɪ f aɪ d
r æ v ə l	r æ v ə l d
r æ v ɪ ʤ	r æ v ɪ ʤ d
r aɪ ð	r aɪ ð d
r aɪ f ə l	r aɪ f ə l d
r aɪ l	r aɪ l d
r aɪ m	r aɪ m d
r aɪ p ə n	r aɪ p ə n d
r aɪ v	r aɪ v d
r aɪ v ə l	r aɪ v ə l d
r aʊ z	r aʊ z d
r eɪ d i oʊ	r eɪ d i oʊ d
r eɪ ʤ	r eɪ ʤ d
r eɪ l	r eɪ l d
r eɪ n	r eɪ n d
r eɪ n	r eɪ n d
r eɪ n	r eɪ n d
r eɪ n ʤ	r eɪ n ʤ d
r eɪ v	r eɪ v d
r eɪ z	r eɪ z d
r eɪ z	r eɪ z d
r ɛ d ə n	r ɛ d ə n d
r ɛ d i	r ɛ d i d
r ɛ ʤ ɪ s t ɚ	r ɛ ʤ ɪ s t ɚ d
r ɛ k ə ɡ n aɪ z	r ɛ k ə ɡ n aɪ z d
r ɛ k ə n	r ɛ k ə n d
r ɛ k ə n ɔɪ t ɚ	r ɛ k ə n ɔɪ t ɚ d
r ɛ k ə n s aɪ l	r ɛ k ə n s aɪ l d
r ɛ k t ɪ f aɪ	r ɛ k t ɪ f aɪ d
r ɛ k w ɪ z ɪ ʃ ə n	r ɛ k w ɪ z ɪ ʃ ə n d
r ɛ m ə d i	r ɛ m ə d i d
r ɛ n d ɚ	r ɛ n d ɚ d
r ɛ s ə l	r ɛ s ə l d
r ɛ s k j u	r ɛ s k j u d
r ɛ v	r ɛ v d
r ɛ v ə l	r ɛ v ə l d
r ɛ v ə l u ʃ ə n aɪ z	r ɛ v ə l u ʃ ə n aɪ z d
r i a r m	r i a r m d
r i ð	r i ð d
r i d ɪ p l ɔɪ	r i d ɪ p l ɔɪ d
r i d ʌ b ə l	r i d ʌ b ə l d
r i ʤ ɔɪ n	r i ʤ ɔɪ n d
r i ə f ɚ m	r i ə f ɚ m d
r i ə l aɪ z	r i ə l aɪ z d
r i ə p i r	r i ə p i r d
r i ə r eɪ n ʤ	r i ə r eɪ n ʤ d
r i ə ʃ u r	r i ə ʃ u r d
r i f ɪ l	r i f ɪ l d
r i f j u ə l	r i f j u ə l d
r i f oʊ r m	r i f oʊ r m d
r i ɡ eɪ n	r i ɡ eɪ n d
r i h aʊ z	r i h aʊ z d
r i j u z	r i j u z d
r i k æ p ʧ ɚ	r i k æ p ʧ ɚ d
r i k ə n s ɪ d ɚ	r i k ə n s ɪ d ɚ d
r i k ɪ n d ə l	r i k ɪ n d ə l d
r i l	r i l d
r i l eɪ	r i l eɪ d
r i l ɪ v	r i l ɪ v d
r i m a d ə l	r i m a d ə l d
r i m eɪ r i	r i m eɪ r i d
r i n eɪ m	r i n eɪ m d
r i oʊ p ə n	r i oʊ p ə n d
r i oʊ r ɡ ə n aɪ z	r i oʊ r ɡ ə n aɪ z d
r i p eɪ	r i p eɪ d
r i p l eɪ	r i p l eɪ d
r i r	r i r d
r i s aɪ k ə l	r i s aɪ k ə l d
r i s ɛ t ə l	r i s ɛ t ə l d
r i s t r ʌ k ʧ ɚ	r i s t r ʌ k ʧ ɚ d
r i t eɪ l	r i t eɪ l d
r i t u l	r i t u l d
r i ʧ a r ʤ	r i ʧ a r ʤ d
r i v æ l j u	r i v æ l j u d
r i v aɪ t ə l aɪ z	r i v aɪ t ə l aɪ z d
r i v ɪ v ɪ f aɪ	r i v ɪ v ɪ f aɪ d
r i z ə n	r i z ə n d
r ɪ b ɛ l	r ɪ b ɛ l d
r ɪ d ə l	r ɪ d ə l d
r ɪ d i m	r ɪ d i m d
r ɪ d ɪ k j u l	r ɪ d ɪ k j u l d
r ɪ ʤ	r ɪ ʤ d
r ɪ f aɪ n	r ɪ f aɪ n d
r ɪ f ə l	r ɪ f ə l d
r ɪ f j u z	r ɪ f j u z d
r ɪ f oʊ r m	r ɪ f oʊ r m d
r ɪ f r eɪ n	r ɪ f r eɪ n d
r ɪ ɡ	r ɪ ɡ d
r ɪ ɡ ə l	r ɪ ɡ ə l d
r ɪ k ə ʃ eɪ	r ɪ k ə ʃ eɪ d
r ɪ k ɚ	r ɪ k ɚ d
r ɪ k l aɪ n	r ɪ k l aɪ n d
r ɪ k l eɪ m	r ɪ k l eɪ m d
r ɪ k ɔ l	r ɪ k ɔ l d
r ɪ k ɔɪ l	r ɪ k ɔɪ l d
r ɪ k ʌ v ɚ	r ɪ k ʌ v ɚ d
r ɪ k w aɪ ɚ	r ɪ k w aɪ ɚ d
r ɪ l i v	r ɪ l i v d
r ɪ m	r ɪ m d
r ɪ m eɪ n	r ɪ m eɪ n d
r ɪ m ɛ m b ɚ	r ɪ m ɛ m b ɚ d
r ɪ m u v	r ɪ m u v d
r ɪ n u	r ɪ n u d
r ɪ ŋ k ə l	r ɪ ŋ k ə l d
r ɪ p eɪ r	r ɪ p eɪ r d
r ɪ p ə l	r ɪ p ə l d
r ɪ p ɛ l	r ɪ p ɛ l d
r ɪ p i l	r ɪ p i l d
r ɪ p l aɪ	r ɪ p l aɪ d
r ɪ p oʊ z	r ɪ p oʊ z d
r ɪ p r i v	r ɪ p r i v d
r ɪ p r u v	r ɪ p r u v d
r ɪ s i v	r ɪ s i v d
r ɪ s t oʊ r	r ɪ s t oʊ r d
r ɪ s t r eɪ n	r ɪ s t r eɪ n d
r ɪ t aɪ ɚ	r ɪ t aɪ ɚ d
r ɪ t eɪ n	r ɪ t eɪ n d
r ɪ t ɚ n	r ɪ t ɚ n d
r ɪ t r i v	r ɪ t r i v d
r ɪ v a l v	r ɪ v a l v d
r ɪ v aɪ l	r ɪ v aɪ l d
r ɪ v aɪ v	r ɪ v aɪ v d
r ɪ v aɪ z	r ɪ v aɪ z d
r ɪ v ɛ n ʤ	r ɪ v ɛ n ʤ d
r ɪ v i l	r ɪ v i l d
r ɪ v i r	r ɪ v i r d
r ɪ v j u	r ɪ v j u d
r ɪ z a l v	r ɪ z a l v d
r ɪ z aɪ n	r ɪ z aɪ n d
r ɪ z ɛ m b ə l	r ɪ z ɛ m b ə l d
r ɪ z ɚ v	r ɪ z ɚ v d
r ɪ z u m	r ɪ z u m d
r oʊ	r oʊ d
r oʊ b	r oʊ b d
r oʊ l	r oʊ l d
r oʊ m	r oʊ m d
r oʊ m æ n t ɪ s aɪ z	r oʊ m æ n t ɪ s aɪ z d
r oʊ r	r oʊ r d
r oʊ v	r oʊ v d
r ɔ ŋ	r ɔ ŋ d
r u ɪ n	r u ɪ n d
r u l	r u l d
r u m	r u m d
r u m ɚ	r u m ɚ d
r u ʒ	r u ʒ d
r ʌ b	r ʌ b d
r ʌ f ə l	r ʌ f ə l d
r ʌ f ə n	r ʌ f ə n d
r ʌ m b ə l	r ʌ m b ə l d
r ʌ m ɪ ʤ	r ʌ m ɪ ʤ d
r ʌ m p ə l	r ʌ m p ə l d
r ʌ p ʧ ɚ	r ʌ p ʧ ɚ d
r ʌ s ə l	r ʌ s ə l d
s a b	s a b d
s a d ɚ	s a d ɚ d
s a l v	s a l v d
s a r oʊ	s a r oʊ d
s æ b ə t a ʒ	s æ b ə t a ʒ d
s æ d ə l	s æ d ə l d
s æ d ə n	s æ d ə n d
s æ ɡ	s æ ɡ d
s æ l v	s æ l v d
s æ l v ɪ ʤ	s æ l v ɪ ʤ d
s æ m p ə l	s æ m p ə l d
s æ n d b æ ɡ	s æ n d b æ ɡ d
s æ ŋ k ʃ ə n	s æ ŋ k ʃ ə n d
s æ ŋ k t ɪ f aɪ	s æ ŋ k t ɪ f aɪ d
s æ t ɚ aɪ z	s æ t ɚ aɪ z d
s æ t ɪ s f aɪ	s æ t ɪ s f aɪ d
s æ v ɪ ʤ	s æ v ɪ ʤ d
s aɪ	s aɪ d
s aɪ ð	s aɪ ð d
s aɪ d ə l	s aɪ d ə l d
s aɪ f ə n	s aɪ f ə n d
s aɪ f ɚ	s aɪ f ɚ d
s aɪ k ə l	s aɪ k ə l d
s aɪ n	s aɪ n d
s aɪ z	s aɪ z d
s aʊ ɚ	s aʊ ɚ d
s eɪ l	s eɪ l d
s eɪ v	s eɪ v d
s eɪ v ɚ	s eɪ v ɚ d
s ə b d u	s ə b d u d
s ə b m ɚ ʤ	s ə b m ɚ ʤ d
s ə b s k r aɪ b	s ə b s k r aɪ b d
s ə b s u m	s ə b s u m d
s ə f j u z	s ə f j u z d
s ə k ʌ m	s ə k ʌ m d
s ə l ɪ d ɪ f aɪ	s ə l ɪ d ɪ f aɪ d
s ə p i n ə	s ə p i n ə d
s ə p l aɪ	s ə p l aɪ d
s ə p oʊ z	s ə p oʊ z d
s ə r ɛ n d ɚ	s ə r ɛ n d ɚ d
s ə s t eɪ n	s ə s t eɪ n d
s ɛ n s ɚ	s ɛ n s ɚ d
s ɛ n s ɪ t aɪ z	s ɛ n s ɪ t aɪ z d
s ɛ n ʃ ɚ	s ɛ n ʃ ɚ d
s ɛ n t ɚ	s ɛ n t ɚ d
s ɛ n t ɪ m ɛ n t ə l aɪ z	s ɛ n t ɪ m ɛ n t ə l aɪ z d
s ɛ n t r ə l aɪ z	s ɛ n t r ə l aɪ z d
s ɛ t ə l	s ɛ t ə l d
s ɛ v ɚ	s ɛ v ɚ d
s ɚ ʤ	s ɚ ʤ d
s ɚ k ə l	s ɚ k ə l d
s ɚ k ə m s aɪ z	s ɚ k ə m s aɪ z d
s ɚ k ə m s k r aɪ b	s ɚ k ə m s k r aɪ b d
s ɚ m aɪ z	s ɚ m aɪ z d
s ɚ p r aɪ z	s ɚ p r aɪ z d
s ɚ t ɪ f aɪ	s ɚ t ɪ f aɪ d
s ɚ v	s ɚ v d
s ɚ v aɪ v	s ɚ v aɪ v d
s ɚ v eɪ	s ɚ v eɪ d
s i ð	s i ð d
s i l	s i l d
s i m	s i m d
s i m	s i m d
s i r	s i r d
s i z	s i z d
s i z ə n	s i z ə n d
s ɪ ɡ n ə l	s ɪ ɡ n ə l d
s ɪ ɡ n ɪ f aɪ	s ɪ ɡ n ɪ f aɪ d
s ɪ k ə n	s ɪ k ə n d
s ɪ k j u r	s ɪ k j u r d
s ɪ l v ɚ	s ɪ l v ɚ d
s ɪ m b ə l aɪ z	s ɪ m b ə l aɪ z d
s ɪ m ɚ	s ɪ m ɚ d
s ɪ m p ə θ aɪ z	s ɪ m p ə θ aɪ z d
s ɪ m p l ɪ f aɪ	s ɪ m p l ɪ f aɪ d
s ɪ n	s ɪ n d
s ɪ n ʤ	s ɪ n ʤ d
s ɪ n θ ə s aɪ z	s ɪ n θ ə s aɪ z d
s ɪ ŋ k r ə n aɪ z	s ɪ ŋ k r ə n aɪ z d
s ɪ s t ɪ m ə t aɪ z	s ɪ s t ɪ m ə t aɪ z d
s ɪ v	s ɪ v d
s ɪ v ɪ l aɪ z	s ɪ v ɪ l aɪ z d
s ɪ z ə l	s ɪ z ə l d
s k a r	s k a r d
s k æ b	s k æ b d
s k æ m p ɚ	s k æ m p ɚ d
s k æ n	s k æ n d
s k æ n d ə l aɪ z	s k æ n d ə l aɪ z d
s k æ t ɚ	s k æ t ɚ d
s k æ v ɪ n ʤ	s k æ v ɪ n ʤ d
s k aɪ	s k aɪ d
s k aʊ ɚ	s k aʊ ɚ d
s k aʊ l	s k aʊ l d
s k eɪ l	s k eɪ l d
s k eɪ r	s k eɪ r d
s k ɛ ʤ u ə l	s k ɛ ʤ u ə l d
s k ɚ ʤ	s k ɚ ʤ d
s k ɚ i	s k ɚ i d
s k i	s k i d
s k i m	s k i m d
s k ɪ m	s k ɪ m d
s k ɪ n	s k ɪ n d
s k ɪ t ɚ	s k ɪ t ɚ d
s k j u ɚ	s k j u ɚ d
s k oʊ r	s k oʊ r d
s k oʊ r n	s k oʊ r n d
s k r æ b ə l	s k r æ b ə l d
s k r æ m b ə l	s k r æ m b ə l d
s k r aɪ b	s k r aɪ b d
s k r aʊ n ʤ	s k r aʊ n ʤ d
s k r i m	s k r i m d
s k r i n	s k r i n d
s k r ɪ b ə l	s k r ɪ b ə l d
s k r ɔ l	s k r ɔ l d
s k r u	s k r u d
s k r u t ɪ n aɪ z	s k r u t ɪ n aɪ z d
s k r ʌ b	s k r ʌ b d
s k u l	s k u l d
s k ʌ f ə l	s k ʌ f ə l d
s k ʌ l p ʧ ɚ	s k ʌ l p ʧ ɚ d
s k ʌ t ə l	s k ʌ t ə l d
s k w a b ə l	s k w a b ə l d
s k w a n d ɚ	s k w a n d ɚ d
s k w eɪ r	s k w eɪ r d
s k w ɚ m	s k w ɚ m d
s k w i l	s k w i l d
s k w i z	s k w i z d
s l a b ɚ	s l a b ɚ d
s l a ɡ	s l a ɡ d
s l æ k ə n	s l æ k ə n d
s l æ m	s l æ m d
s l æ n d ɚ	s l æ n d ɚ d
s l eɪ v	s l eɪ v d
s l ɚ	s l ɚ d
s l ɪ ð ɚ	s l ɪ ð ɚ d
s l ɪ m	s l ɪ m d
s l oʊ	s l oʊ d
s l ɔ t ɚ	s l ɔ t ɚ d
s l u	s l u d
s l ʌ ɡ	s l ʌ ɡ d
s l ʌ m b ɚ	s l ʌ m b ɚ d
s m aɪ l	s m aɪ l d
s m ɛ l	s m ɛ l d
s m i r	s m i r d
s m oʊ l d ɚ	s m oʊ l d ɚ d
s m u ð	s m u ð d
s m ʌ ð ɚ	s m ʌ ð ɚ d
s m ʌ ʤ	s m ʌ ʤ d
s m ʌ ɡ ə l	s m ʌ ɡ ə l d
s n a r l	s n a r l d
s n æ ɡ	s n æ ɡ d
s n eɪ r	s n eɪ r d
s n i r	s n i r d
s n i z	s n i z d
s n ɪ f ə l	s n ɪ f ə l d
s n ɪ ɡ ɚ	s n ɪ ɡ ɚ d
s n ɪ k ɚ	s n ɪ k ɚ d
s n ɪ v ə l	s n ɪ v ə l d
s n oʊ	s n oʊ d
s n oʊ b ɔ l	s n oʊ b ɔ l d
s n oʊ r	s n oʊ r d
s n u z	s n u z d
s n ʌ b	s n ʌ b d
s n ʌ f ə l	s n ʌ f ə l d
s n ʌ ɡ ə l	s n ʌ ɡ ə l d
s oʊ	s oʊ d
s oʊ	s oʊ d
s oʊ b ɚ	s oʊ b ɚ d
s oʊ ʤ ɚ n	s oʊ ʤ ɚ n d
s oʊ l ʤ ɚ	s oʊ l ʤ ɚ d
s oʊ r	s oʊ r d
s oʊ ʃ ə l aɪ z	s oʊ ʃ ə l aɪ z d
s ɔ	s ɔ d
s ɔ f ə n	s ɔ f ə n d
s ɔ n t ɚ	s ɔ n t ɚ d
s ɔɪ l	s ɔɪ l d
s p a n s ɚ	s p a n s ɚ d
s p a r	s p a r d
s p a r k ə l	s p a r k ə l d
s p æ n	s p æ n d
s p æ ŋ ɡ ə l	s p æ ŋ ɡ ə l d
s p æ t ɚ	s p æ t ɚ d
s p aɪ	s p aɪ d
s p aɪ r ə l	s p aɪ r ə l d
s p eɪ	s p eɪ d
s p eɪ r	s p eɪ r d
s p ɛ l	s p ɛ l d
s p ɛ s ɪ f aɪ	s p ɛ s ɪ f aɪ d
s p ɛ ʃ ə l aɪ z	s p ɛ ʃ ə l aɪ z d
s p ɚ	s p ɚ d
s p ɚ n	s p ɚ n d
s p i r	s p i r d
s p ɪ l	s p ɪ l d
s p j u	s p j u d
s p l æ t ɚ	s p l æ t ɚ d
s p l eɪ	s p l eɪ d
s p l ɚ ʤ	s p l ɚ ʤ d
s p l ɪ n t ɚ	s p l ɪ n t ɚ d
s p l ʌ t ɚ	s p l ʌ t ɚ d
s p ɔ n	s p ɔ n d
s p ɔɪ l	s p ɔɪ l d
s p r eɪ	s p r eɪ d
s p r eɪ n	s p r eɪ n d
s p r ɛ d i ɡ ə l	s p r ɛ d i ɡ ə l d
s p r ɪ ŋ k ə l	s p r ɪ ŋ k ə l d
s p r ɔ l	s p r ɔ l d
s p u n	s p u n d
s p ʌ n ʤ	s p ʌ n ʤ d
s p ʌ t ɚ	s p ʌ t ɚ d
s t a k p aɪ l	s t a k p aɪ l d
s t a r	s t a r d
s t a r t ə l	s t a r t ə l d
s t a r v	s t a r v d
s t æ b	s t æ b d
s t æ ɡ ɚ	s t æ ɡ ɚ d
s t æ m ɚ	s t æ m ɚ d
s t æ n d ɚ d aɪ z	s t æ n d ɚ d aɪ z d
s t aɪ f ə l	s t aɪ f ə l d
s t aɪ l	s t aɪ l d
s t aɪ l aɪ z	s t aɪ l aɪ z d
s t eɪ	s t eɪ d
s t eɪ b ə l	s t eɪ b ə l d
s t eɪ b ə l aɪ z	s t eɪ b ə l aɪ z d
s t eɪ ʤ	s t eɪ ʤ d
s t eɪ n	s t eɪ n d
s t eɪ r	s t eɪ r d
s t eɪ r ə l aɪ z	s t eɪ r ə l aɪ z d
s t eɪ ʃ ə n	s t eɪ ʃ ə n d
s t ɛ d i	s t ɛ d i d
s t ɛ m	s t ɛ m d
s t ɛ n s ə l	s t ɛ n s ə l d
s t ɚ	s t ɚ d
s t i l	s t i l d
s t i m	s t i m d
s t i r	s t i r d
s t ɪ f ə n	s t ɪ f ə n d
s t ɪ ɡ m ə t aɪ z	s t ɪ ɡ m ə t aɪ z d
s t ɪ l	s t ɪ l d
s t oʊ	s t oʊ d
s t oʊ n	s t oʊ n d
s t oʊ n w ɔ l	s t oʊ n w ɔ l d
s t oʊ r	s t oʊ r d
s t oʊ r m	s t oʊ r m d
s t ɔ l	s t ɔ l d
s t r æ d ə l	s t r æ d ə l d
s t r æ ɡ ə l	s t r æ ɡ ə l d
s t r æ ŋ ɡ ə l	s t r æ ŋ ɡ ə l d
s t r æ t ɪ f aɪ	s t r æ t ɪ f aɪ d
s t r eɪ	s t r eɪ d
s t r eɪ n	s t r eɪ n d
s t r eɪ t ə n	s t r eɪ t ə n d
s t r ɛ ŋ θ ə n	s t r ɛ ŋ θ ə n d
s t r i m	s t r i m d
s t r i m l aɪ n	s t r i m l aɪ n d
s t r oʊ l	s t r oʊ l d
s t r u	s t r u d
s t r ʌ ɡ ə l	s t r ʌ ɡ ə l d
s t r ʌ k ʧ ɚ	s t r ʌ k ʧ ɚ d
s t r ʌ m	s t r ʌ m d
s t u	s t u d
s t u p ɪ f aɪ	s t u p ɪ f aɪ d
s t ʌ b	s t ʌ b d
s t ʌ d i	s t ʌ d i d
s t ʌ l t ɪ f aɪ	s t ʌ l t ɪ f aɪ d
s t ʌ m b ə l	s t ʌ m b ə l d
s t ʌ n	s t ʌ n d
s t ʌ t ɚ	s t ʌ t ɚ d
s u	s u d
s u ð	s u ð d
s u p ə r ɪ m p oʊ z	s u p ə r ɪ m p oʊ z d
s u p ɚ v aɪ z	s u p ɚ v aɪ z d
s ʌ b	s ʌ b d
s ʌ b s ɪ d aɪ z	s ʌ b s ɪ d aɪ z d
s ʌ f ɚ	s ʌ f ɚ d
s ʌ k ə l	s ʌ k ə l d
s ʌ l i	s ʌ l i d
s ʌ m ə n	s ʌ m ə n d
s ʌ m ə r aɪ z	s ʌ m ə r aɪ z d
s ʌ n	s ʌ n d
s ʌ n b eɪ ð	s ʌ n b eɪ ð d
s w a b	s w a b d
s w a d ə l	s w a d ə l d
s w a l oʊ	s w a l oʊ d
s w æ ɡ ɚ	s w æ ɡ ɚ d
s w eɪ	s w eɪ d
s w ɛ l	s w ɛ l d
s w ɚ l	s w ɚ l d
s w ɚ v	s w ɚ v d
s w i t ə n	s w i t ə n d
s w ɪ ɡ	s w ɪ ɡ d
s w ɪ l	s w ɪ l d
s w ɪ n d ə l	s w ɪ n d ə l d
s w ɪ v ə l	s w ɪ v ə l d
s w oʊ r m	s w oʊ r m d
s w ɔ ð	s w ɔ ð d
s w u n	s w u n d
ʃ a r p ə n	ʃ a r p ə n d
ʃ æ d oʊ	ʃ æ d oʊ d
ʃ æ k ə l	ʃ æ k ə l d
ʃ æ m b ə l	ʃ æ m b ə l d
ʃ æ ŋ h aɪ	ʃ æ ŋ h aɪ d
ʃ æ p ə r oʊ n	ʃ æ p ə r oʊ n d
ʃ æ t ɚ	ʃ æ t ɚ d
ʃ aɪ	ʃ aɪ d
ʃ aɪ n	ʃ aɪ n d
ʃ aʊ ɚ	ʃ aʊ ɚ d
ʃ eɪ m	ʃ eɪ m d
ʃ eɪ r	ʃ eɪ r d
ʃ eɪ v	ʃ eɪ v d
ʃ ə ɡ r ɪ n	ʃ ə ɡ r ɪ n d
ʃ ɛ l	ʃ ɛ l d
ʃ ɛ l t ɚ	ʃ ɛ l t ɚ d
ʃ ɛ l v	ʃ ɛ l v d
ʃ i ð	ʃ i ð d
ʃ i r	ʃ i r d
ʃ ɪ m ɚ	ʃ ɪ m ɚ d
ʃ ɪ v ɚ	ʃ ɪ v ɚ d
ʃ oʊ	ʃ oʊ d
ʃ oʊ l d ɚ	ʃ oʊ l d ɚ d
ʃ oʊ r	ʃ oʊ r d
ʃ oʊ r t ə n	ʃ oʊ r t ə n d
ʃ r ɪ l	ʃ r ɪ l d
ʃ r ɪ v ə l	ʃ r ɪ v ə l d
ʃ r ʌ ɡ	ʃ r ʌ ɡ d
ʃ u	ʃ u d
ʃ u	ʃ u d
ʃ ʊ ɡ ɚ	ʃ ʊ ɡ ɚ d
ʃ ʌ d ɚ	ʃ ʌ d ɚ d
ʃ ʌ f ə l	ʃ ʌ f ə l d
ʃ ʌ n	ʃ ʌ n d
ʃ ʌ t ə l	ʃ ʌ t ə l d
ʃ ʌ t ɚ	ʃ ʌ t ɚ d
ʃ ʌ v	ʃ ʌ v d
ʃ ʌ v ə l	ʃ ʌ v ə l d
t a d ə l	t a d ə l d
t a p ə l	t a p ə l d
t a r	t a r d
t a t ɚ	t a t ɚ d
t æ ɡ	t æ ɡ d
t æ k ə l	t æ k ə l d
t æ k s i	t æ k s i d
t æ l i	t æ l i d
t æ n	t æ n d
t æ n t ə l aɪ z	t æ n t ə l aɪ z d
t æ ŋ ɡ ə l	t æ ŋ ɡ ə l d
t æ t u	t æ t u d
t aɪ	t aɪ d
t aɪ d i	t aɪ d i d
t aɪ ɚ	t aɪ ɚ d
t aɪ l	t aɪ l d
t aɪ m	t aɪ m d
t aɪ t ə n	t aɪ t ə n d
t aʊ ɚ	t aʊ ɚ d
t aʊ z ə l	t aʊ z ə l d
t eɪ b ə l	t eɪ b ə l d
t eɪ l	t eɪ l d
t eɪ l ɚ	t eɪ l ɚ d
t eɪ m	t eɪ m d
t eɪ p ɚ	t eɪ p ɚ d
t eɪ r ə r aɪ z	t eɪ r ə r aɪ z d
t eɪ r ɪ f aɪ	t eɪ r ɪ f aɪ d
t ɛ ð ɚ	t ɛ ð ɚ d
t ɛ l ə f oʊ n	t ɛ l ə f oʊ n d
t ɛ l ɪ v aɪ z	t ɛ l ɪ v aɪ z d
t ɛ m p ɚ	t ɛ m p ɚ d
t ɛ n d ɚ	t ɛ n d ɚ d
t ɛ s t ə f aɪ	t ɛ s t ə f aɪ d
t ɚ m	t ɚ m d
t ɚ n	t ɚ n d
t i	t i d
t i ð	t i ð d
t i m	t i m d
t i t ɚ	t i t ɚ d
t i z	t i z d
t ɪ k ə l	t ɪ k ə l d
t ɪ l	t ɪ l d
t ɪ n	t ɪ n d
t ɪ n ʤ	t ɪ n ʤ d
t ɪ ŋ ɡ ə l	t ɪ ŋ ɡ ə l d
t ɪ ŋ k ə l	t ɪ ŋ k ə l d
t ɪ ŋ k ɚ	t ɪ ŋ k ɚ d
t ɪ p ɪ f aɪ	t ɪ p ɪ f aɪ d
t ɪ p t oʊ	t ɪ p t oʊ d
t ɪ t ɚ	t ɪ t ɚ d
t oʊ	t oʊ d
t oʊ	t oʊ d
t oʊ l	t oʊ l d
t oʊ n	t oʊ n d
t oʊ r p i d oʊ	t oʊ r p i d oʊ d
t oʊ r ʧ ɚ	t oʊ r ʧ ɚ d
t oʊ t ə l	t oʊ t ə l d
t ɔɪ l	t ɔɪ l d
t r æ m p ə l	t r æ m p ə l d
t r æ n s f ɚ	t r æ n s f ɚ d
t r æ n s f ɪ ɡ j ɚ	t r æ n s f ɪ ɡ j ɚ d
t r æ n s f oʊ r m	t r æ n s f oʊ r m d
t r æ n s k r aɪ b	t r æ n s k r aɪ b d
t r æ n s p aɪ ɚ	t r æ n s p aɪ ɚ d
t r æ n s p oʊ z	t r æ n s p oʊ z d
t r æ ŋ k w ɪ l aɪ z	t r æ ŋ k w ɪ l aɪ z d
t r æ v ə l	t r æ v ə l d
t r aɪ	t r aɪ d
t r eɪ l	t r eɪ l d
t r eɪ n	t r eɪ n d
t r ɛ b ə l	t r ɛ b ə l d
t r ɛ m b ə l	t r ɛ m b ə l d
t r ɛ ʒ ɚ	t r ɛ ʒ ɚ d
t r ɪ ɡ ɚ	t r ɪ ɡ ɚ d
t r ɪ k ə l	t r ɪ k ə l d
t r ɪ l	t r ɪ l d
t r ɪ m	t r ɪ m d
t r ɪ p ə l	t r ɪ p ə l d
t r oʊ l	t r oʊ l d
t r ɔ l	t r ɔ l d
t r ʌ b ə l	t r ʌ b ə l d
t r ʌ ʤ	t r ʌ ʤ d
t r ʌ n d ə l	t r ʌ n d ə l d
t u l	t u l d
t u n	t u n d
t u r	t u r d
t u t ɚ	t u t ɚ d
t ʌ f ə n	t ʌ f ə n d
t ʌ ɡ	t ʌ ɡ d
t ʌ m b ə l	t ʌ m b ə l d
t ʌ n ə l	t ʌ n ə l d
t w æ ŋ	t w æ ŋ d
t w aɪ n	t w aɪ n d
t w ɚ l	t w ɚ l d
t w ɪ d ə l	t w ɪ d ə l d
t w ɪ ŋ k ə l	t w ɪ ŋ k ə l d
t w ɪ t ɚ	t w ɪ t ɚ d
ʧ a r	ʧ a r d
ʧ a r ʤ	ʧ a r ʤ d
ʧ a r m	ʧ a r m d
ʧ a r t ɚ	ʧ a r t ɚ d
ʧ æ l ə n ʤ	ʧ æ l ə n ʤ d
ʧ æ m p i ə n	ʧ æ m p i ə n d
ʧ æ n ə l	ʧ æ n ə l d
ʧ æ s t aɪ z	ʧ æ s t aɪ z d
ʧ æ t ɚ	ʧ æ t ɚ d
ʧ aɪ m	ʧ aɪ m d
ʧ eɪ n	ʧ eɪ n d
ʧ eɪ n ʤ	ʧ eɪ n ʤ d
ʧ eɪ r	ʧ eɪ r d
ʧ eɪ s ə n	ʧ eɪ s ə n d
ʧ ɛ k ɚ	ʧ ɛ k ɚ d
ʧ ɚ n	ʧ ɚ n d
ʧ i p ə n	ʧ i p ə n d
ʧ i r	ʧ i r d
ʧ ɪ l	ʧ ɪ l d
ʧ ɪ z ə l	ʧ ɪ z ə l d
ʧ u	ʧ u d
ʧ ʌ ɡ	ʧ ʌ ɡ d
ʧ ʌ k ə l	ʧ ʌ k ə l d
u z	u z d
v a l ə n t i r	v a l ə n t i r d
v a l i	v a l i d
v æ k j u m	v æ k j u m d
v æ l j u	v æ l j u d
v æ n d ə l aɪ z	v æ n d ə l aɪ z d
v aɪ	v aɪ d
v aʊ	v aʊ d
v eɪ k eɪ ʃ ə n	v eɪ k eɪ ʃ ə n d
v eɪ l	v eɪ l d
v eɪ p ə r aɪ z	v eɪ p ə r aɪ z d
v eɪ r i	v eɪ r i d
v eɪ r ɪ f aɪ	v eɪ r ɪ f aɪ d
v ɛ n ʧ ɚ	v ɛ n ʧ ɚ d
v ɚ b ə l aɪ z	v ɚ b ə l aɪ z d
v i r	v i r d
v i t oʊ	v i t oʊ d
v ɪ k t ɪ m aɪ z	v ɪ k t ɪ m aɪ z d
v ɪ l ɪ f aɪ	v ɪ l ɪ f aɪ d
v ɪ ʒ u ə l aɪ z	v ɪ ʒ u ə l aɪ z d
v j u	v j u d
ʌ n b ɚ d ə n	ʌ n b ɚ d ə n d
ʌ n b ʌ k ə l	ʌ n b ʌ k ə l d
ʌ n d ɚ l aɪ n	ʌ n d ɚ l aɪ n d
ʌ n d ɚ m aɪ n	ʌ n d ɚ m aɪ n d
ʌ n d ɚ p eɪ	ʌ n d ɚ p eɪ d
ʌ n d ɚ p ɪ n	ʌ n d ɚ p ɪ n d
ʌ n d ɚ p l eɪ	ʌ n d ɚ p l eɪ d
ʌ n d ɚ s k oʊ r	ʌ n d ɚ s k oʊ r d
ʌ n d ɚ s t ʌ d i	ʌ n d ɚ s t ʌ d i d
ʌ n d ɚ v æ l j u	ʌ n d ɚ v æ l j u d
ʌ n f ɚ l	ʌ n f ɚ l d
ʌ n h ɪ n ʤ	ʌ n h ɪ n ʤ d
ʌ n k ʌ p ə l	ʌ n k ʌ p ə l d
ʌ n k ʌ v ɚ	ʌ n k ʌ v ɚ d
ʌ n l ɚ n	ʌ n l ɚ n d
ʌ n n ɚ v	ʌ n n ɚ v d
ʌ n r æ v ə l	ʌ n r æ v ə l d
ʌ n r oʊ l	ʌ n r oʊ l d
ʌ n s ɛ t ə l	ʌ n s ɛ t ə l d
ʌ n s k r u	ʌ n s k r u d
ʌ n t æ ŋ ɡ ə l	ʌ n t æ ŋ ɡ ə l d
ʌ n v eɪ l	ʌ n v eɪ l d
ʌ p h oʊ l s t ɚ	ʌ p h oʊ l s t ɚ d
ʌ p s t eɪ ʤ	ʌ p s t eɪ ʤ d
ʌ ʃ ɚ	ʌ ʃ ɚ d
ʌ t ɚ	ʌ t ɚ d
w a b ə l	w a b ə l d
w a d ə l	w a d ə l d
w a l oʊ	w a l oʊ d
w a n d ɚ	w a n d ɚ d
w æ ɡ	w æ ɡ d
w æ ɡ ə l	w æ ɡ ə l d
w æ ŋ ɡ ə l	w æ ŋ ɡ ə l d
w aɪ d ə n	w aɪ d ə n d
w aɪ ɚ	w aɪ ɚ d
w aɪ n	w aɪ n d
w aɪ t ə n	w aɪ t ə n d
w eɪ	w eɪ d
w eɪ ʤ	w eɪ ʤ d
w eɪ ʤ ɚ	w eɪ ʤ ɚ d
w eɪ k ə n	w eɪ k ə n d
w eɪ l	w eɪ l d
w eɪ l eɪ	w eɪ l eɪ d
w eɪ n	w eɪ n d
w eɪ v	w eɪ v d
w eɪ v	w eɪ v d
w eɪ v ɚ	w eɪ v ɚ d
w ɛ ð ɚ	w ɛ ð ɚ d
w ɛ ʤ	w ɛ ʤ d
w ɛ l	w ɛ l d
w ɛ l k ə m	w ɛ l k ə m d
w ɛ s t ɚ n aɪ z	w ɛ s t ɚ n aɪ z d
w ɚ	w ɚ d
w ɚ i	w ɚ i d
w ɚ l	w ɚ l d
w ɚ m	w ɚ m d
w ɚ s ə n	w ɚ s ə n d
w i d ə l	w i d ə l d
w i k ə n	w i k ə n d
w i l	w i l d
w i n	w i n d
w i r i	w i r i d
w i z	w i z d
w ɪ ð ɚ	w ɪ ð ɚ d
w ɪ ɡ ə l	w ɪ ɡ ə l d
w ɪ m p ɚ	w ɪ m p ɚ d
w ɪ n i	w ɪ n i d
w ɪ n oʊ	w ɪ n oʊ d
w ɪ n t ɚ	w ɪ n t ɚ d
w ɪ ŋ	w ɪ ŋ d
w ɪ s ə l	w ɪ s ə l d
w ɪ s p ɚ	w ɪ s p ɚ d
w ɪ t ə l	w ɪ t ə l d
w ɪ z	w ɪ z d
w oʊ r	w oʊ r d
w oʊ r b ə l	w oʊ r b ə l d
w oʊ r m	w oʊ r m d
w oʊ r n	w oʊ r n d
w ɔ l	w ɔ l d
w ɔ t ɚ	w ɔ t ɚ d
w u	w u d
w ʌ n d ɚ	w ʌ n d ɚ d
z ɪ ɡ z æ ɡ	z ɪ ɡ z æ ɡ d
z u m	z u m d
θ i ə r aɪ z	θ i ə r aɪ z d
θ ɪ k ə n	θ ɪ k ə n d
θ ɪ n	θ ɪ n d
θ ɔ	θ ɔ d
θ r a b	θ r a b d
θ r a t ə l	θ r a t ə l d
θ r aɪ v	θ r aɪ v d
θ r ɛ t ə n	θ r ɛ t ə n d
θ r ɪ l	θ r ɪ l d
θ r ɔ ŋ	θ r ɔ ŋ d
θ ʌ m	θ ʌ m d
θ ʌ n d ɚ	θ ʌ n d ɚ d
















a r ʧ	a r ʧ t
æ d m a n ɪ ʃ	æ d m a n ɪ ʃ t
æ k w i ɛ s	æ k w i ɛ s t
æ m b ʊ ʃ	æ m b ʊ ʃ t
æ s k	æ s k t
aɪ s	aɪ s t
aʊ t d ɪ s t ə n s	aʊ t d ɪ s t ə n s t
aʊ t f l æ ŋ k	aʊ t f l æ ŋ k t
aʊ t s t r ɪ p	aʊ t s t r ɪ p t
b a k s	b a k s t
b a p	b a p t
b a r k	b a r k t
b a ʧ	b a ʧ t
b æ k	b æ k t
b æ k t r æ k	b æ k t r æ k t
b æ l ə n s	b æ l ə n s t
b æ n ɪ ʃ	b æ n ɪ ʃ t
b æ ŋ k	b æ ŋ k t
b æ s k	b æ s k t
b æ ʃ	b æ ʃ t
b æ θ	b æ θ t
b aɪ ə s	b aɪ ə s t
b aɪ p æ s	b aɪ p æ s t
b aʊ n s	b aʊ n s t
b eɪ k	b eɪ k t
b ɛ l ʧ	b ɛ l ʧ t
b ɚ k	b ɚ k t
b ɚ n	b ɚ n t
b ɚ n ɪ ʃ	b ɚ n ɪ ʃ t
b ɚ p	b ɚ p t
b i ʧ	b i ʧ t
b ɪ k w i θ	b ɪ k w i θ t
b ɪ ʧ	b ɪ ʧ t
b ɪ v w æ k	b ɪ v w æ k t
b ɪ w ɪ ʧ	b ɪ w ɪ ʧ t
b l a k	b l a k t
b l æ k	b l æ k t
b l æ n ʧ	b l æ n ʧ t
b l ɛ s	b l ɛ s t
b l i ʧ	b l i ʧ t
b l ɪ ŋ k	b l ɪ ŋ k t
b l ɪ t s	b l ɪ t s t
b l ʌ f	b l ʌ f t
b l ʌ ʃ	b l ʌ ʃ t
b ɔ k	b ɔ k t
b ɔ s	b ɔ s t
b r æ n d ɪ ʃ	b r æ n d ɪ ʃ t
b r æ n ʧ	b r æ n ʧ t
b r eɪ k	b r eɪ k t
b r eɪ n w ɔ ʃ	b r eɪ n w ɔ ʃ t
b r eɪ s	b r eɪ s t
b r i f	b r i f t
b r i ʧ	b r i ʧ t
b r oʊ ʧ	b r oʊ ʧ t
b r ʊ k	b r ʊ k t
b r ʌ ʃ	b r ʌ ʃ t
b ʊ k	b ʊ k t
b ʌ k	b ʌ k t
b ʌ m p	b ʌ m p t
b ʌ n ʧ	b ʌ n ʧ t
b ʌ s	b ʌ s t
b ʌ t r ɪ s	b ʌ t r ɪ s t
d a f	d a f t
d a k	d a k t
d æ m p	d æ m p t
d æ n s	d æ n s t
d æ ʃ	d æ ʃ t
d aɪ ə ɡ n oʊ s	d aɪ ə ɡ n oʊ s t
d aɪ ɡ r ɛ s	d aɪ ɡ r ɛ s t
d aɪ s	d aɪ s t
d aʊ s	d aʊ s t
d ɛ k	d ɛ k t
d i k r i s	d i k r i s t
d ɪ b a r k	d ɪ b a r k t
d ɪ b eɪ s	d ɪ b eɪ s t
d ɪ b ɔ ʧ	d ɪ b ɔ ʧ t
d ɪ d u s	d ɪ d u s t
d ɪ f eɪ s	d ɪ f eɪ s t
d ɪ k æ m p	d ɪ k æ m p t
d ɪ m a l ɪ ʃ	d ɪ m a l ɪ ʃ t
d ɪ m ɪ n ɪ ʃ	d ɪ m ɪ n ɪ ʃ t
d ɪ n aʊ n s	d ɪ n aʊ n s t
d ɪ p	d ɪ p t
d ɪ p r ɛ s	d ɪ p r ɛ s t
d ɪ s b ɚ s	d ɪ s b ɚ s t
d ɪ s ɡ r eɪ s	d ɪ s ɡ r eɪ s t
d ɪ s ɪ m b a r k	d ɪ s ɪ m b a r k t
d ɪ s k ʌ s	d ɪ s k ʌ s t
d ɪ s l aɪ k	d ɪ s l aɪ k t
d ɪ s m ɪ s	d ɪ s m ɪ s t
d ɪ s p æ ʧ	d ɪ s p æ ʧ t
d ɪ s p ə z ɛ s	d ɪ s p ə z ɛ s t
d ɪ s p ɛ n s	d ɪ s p ɛ n s t
d ɪ s p ɚ s	d ɪ s p ɚ s t
d ɪ s p l eɪ s	d ɪ s p l eɪ s t
d ɪ s t ə n s	d ɪ s t ə n s t
d ɪ s t ɪ ŋ ɡ w ɪ ʃ	d ɪ s t ɪ ŋ ɡ w ɪ ʃ t
d ɪ s t r ɛ s	d ɪ s t r ɛ s t
d ɪ ʃ	d ɪ ʃ t
d ɪ t æ ʧ	d ɪ t æ ʧ t
d ɪ ʧ	d ɪ ʧ t
d ɪ v ɛ l ə p	d ɪ v ɛ l ə p t
d ɪ v oʊ r s	d ɪ v oʊ r s t
d oʊ p	d oʊ p t
d oʊ s	d oʊ s t
d r a p	d r a p t
d r eɪ p	d r eɪ p t
d r ɛ n ʧ	d r ɛ n ʧ t
d r ɛ s	d r ɛ s t
d r ɪ p	d r ɪ p t
d r u p	d r u p t
d u p	d u p t
d ʌ b ə l k r ɔ s	d ʌ b ə l k r ɔ s t
d ʌ b ə l ʧ ɛ k	d ʌ b ə l ʧ ɛ k t
d ʌ k	d ʌ k t
d ʌ m p	d ʌ m p t
d ʌ ŋ k	d ʌ ŋ k t
d w ɛ l	d w ɛ l t
d w oʊ r f	d w oʊ r f t
ʤ a ʃ	ʤ a ʃ t
ʤ ɚ k	ʤ ɚ k t
ʤ oʊ k	ʤ oʊ k t
ʤ ʌ m p	ʤ ʌ m p t
eɪ k	eɪ k t
eɪ p	eɪ p t
ə b a l ɪ ʃ	ə b a l ɪ ʃ t
ə b æ ʃ	ə b æ ʃ t
ə b s ɛ s	ə b s ɛ s t
ə d r ɛ s	ə d r ɛ s t
ə d u s	ə d u s t
ə d v æ n s	ə d v æ n s t
ə f ɪ k s	ə f ɪ k s t
ə k a m p l ɪ ʃ	ə k a m p l ɪ ʃ t
ə m æ s	ə m æ s t
ə n aʊ n s	ə n aʊ n s t
ə n ɛ k s	ə n ɛ k s t
ə p r ɛ n t ɪ s	ə p r ɛ n t ɪ s t
ə p r ɛ s	ə p r ɛ s t
ə p r oʊ ʧ	ə p r oʊ ʧ t
ə s ɛ s	ə s ɛ s t
ə s t a n ɪ ʃ	ə s t a n ɪ ʃ t
ə t æ k	ə t æ k t
ə t æ ʧ	ə t æ ʧ t
ɛ ʧ	ɛ ʧ t
ɛ v ɪ d ə n s	ɛ v ɪ d ə n s t
ɚ k	ɚ k t
f aɪ n æ n s	f aɪ n æ n s t
f eɪ k	f eɪ k t
f eɪ s	f eɪ s t
f ɛ n s	f ɛ n s t
f ɛ ʧ	f ɛ ʧ t
f ɚ n ɪ ʃ	f ɚ n ɪ ʃ t
f ɪ k s	f ɪ k s t
f ɪ l ʧ	f ɪ l ʧ t
f ɪ n ɪ ʃ	f ɪ n ɪ ʃ t
f ɪ ʃ	f ɪ ʃ t
f l a k	f l a k t
f l a p	f l a p t
f l æ ŋ k	f l æ ŋ k t
f l æ p	f l æ p t
f l æ ʃ	f l æ ʃ t
f l aʊ n s	f l aʊ n s t
f l eɪ k	f l eɪ k t
f l ɛ k	f l ɛ k t
f l ɛ k s	f l ɛ k s t
f l ɚ ɪ ʃ	f l ɚ ɪ ʃ t
f l ɪ k	f l ɪ k t
f l ɪ n ʧ	f l ɪ n ʧ t
f l ɪ p	f l ɪ p t
f l ʌ f	f l ʌ f t
f l ʌ ŋ k	f l ʌ ŋ k t
f l ʌ ʃ	f l ʌ ʃ t
f oʊ k ə s	f oʊ k ə s t
f oʊ r k	f oʊ r k t
f oʊ r s	f oʊ r s t
f oʊ t ə ɡ r æ f	f oʊ t ə ɡ r æ f t
f r a l ɪ k	f r a l ɪ k t
f r i k	f r i k t
f r ɪ s k	f r ɪ s k t
f r ɔ θ	f r ɔ θ t
f ʌ k	f ʌ k t
f ʌ s	f ʌ s t
ɡ a l f	ɡ a l f t
ɡ a r n ɪ ʃ	ɡ a r n ɪ ʃ t
ɡ a s ɪ p	ɡ a s ɪ p t
ɡ æ l ə p	ɡ æ l ə p t
ɡ æ s	ɡ æ s t
ɡ æ s p	ɡ æ s p t
ɡ æ ʃ	ɡ æ ʃ t
ɡ eɪ p	ɡ eɪ p t
ɡ ɛ s	ɡ ɛ s t
ɡ l æ n s	ɡ l æ n s t
ɡ l ɪ m p s	ɡ l ɪ m p s t
ɡ l ɔ s	ɡ l ɔ s t
ɡ r æ s p	ɡ r æ s p t
ɡ r aɪ p	ɡ r aɪ p t
ɡ r eɪ s	ɡ r eɪ s t
ɡ r i s	ɡ r i s t
ɡ r ɪ m ə s	ɡ r ɪ m ə s t
ɡ r ɪ p	ɡ r ɪ p t
ɡ r oʊ p	ɡ r oʊ p t
ɡ r u p	ɡ r u p t
ɡ u f	ɡ u f t
ɡ ʌ l p	ɡ ʌ l p t
ɡ ʌ ʃ	ɡ ʌ ʃ t
h a p	h a p t
h a r k	h a r k t
h a r n ɪ s	h a r n ɪ s t
h æ k	h æ k t
h æ n d i k æ p	h æ n d i k æ p t
h æ n d k ʌ f	h æ n d k ʌ f t
h æ ʧ	h æ ʧ t
h aɪ ʤ æ k	h aɪ ʤ æ k t
h aɪ k	h aɪ k t
h ɛ l p	h ɛ l p t
h ɚ æ s	h ɚ æ s t
h i p	h i p t
h ɪ k ʌ p	h ɪ k ʌ p t
h ɪ s	h ɪ s t
h ɪ ʧ	h ɪ ʧ t
h ɪ ʧ h aɪ k	h ɪ ʧ h aɪ k t
h oʊ p	h oʊ p t
h ɔ k	h ɔ k t
h ɔ ŋ k	h ɔ ŋ k t
h ʊ d w ɪ ŋ k	h ʊ d w ɪ ŋ k t
h ʊ k	h ʊ k t
h ʌ f	h ʌ f t
h ʌ m p	h ʌ m p t
h ʌ n ʧ	h ʌ n ʧ t
h ʌ ʃ	h ʌ ʃ t
i r eɪ s	i r eɪ s t
i r m a r k	i r m a r k t
i v z d r a p	i v z d r a p t
ɪ f eɪ s	ɪ f eɪ s t
ɪ k l ɪ p s	ɪ k l ɪ p s t
ɪ k s p i r i ə n s	ɪ k s p i r i ə n s t
ɪ k s p r ɛ s	ɪ k s p r ɛ s t
ɪ k s t ɪ ŋ ɡ w ɪ ʃ	ɪ k s t ɪ ŋ ɡ w ɪ ʃ t
ɪ k w ɪ p	ɪ k w ɪ p t
ɪ l æ p s	ɪ l æ p s t
ɪ l oʊ p	ɪ l oʊ p t
ɪ m b a r k	ɪ m b a r k t
ɪ m b eɪ r ə s	ɪ m b eɪ r ə s t
ɪ m b ɛ l ɪ ʃ	ɪ m b ɛ l ɪ ʃ t
ɪ m b ɔ s	ɪ m b ɔ s t
ɪ m b r eɪ s	ɪ m b r eɪ s t
ɪ m ɚ s	ɪ m ɚ s t
ɪ m p a v ə r ɪ ʃ	ɪ m p a v ə r ɪ ʃ t
ɪ m p i ʧ	ɪ m p i ʧ t
ɪ m p r ɛ s	ɪ m p r ɛ s t
ɪ n d ɛ k s	ɪ n d ɛ k s t
ɪ n d oʊ r s	ɪ n d oʊ r s t
ɪ n d u s	ɪ n d u s t
ɪ n f l u ə n s	ɪ n f l u ə n s t
ɪ n f oʊ r s	ɪ n f oʊ r s t
ɪ n ɡ r oʊ s	ɪ n ɡ r oʊ s t
ɪ n ɡ ʌ l f	ɪ n ɡ ʌ l f t
ɪ n h æ n s	ɪ n h æ n s t
ɪ n k æ m p	ɪ n k æ m p t
ɪ n k eɪ s	ɪ n k eɪ s t
ɪ n k ə n v i n j ə n s	ɪ n k ə n v i n j ə n s t
ɪ n k r i s	ɪ n k r i s t
ɪ n k r oʊ ʧ	ɪ n k r oʊ ʧ t
ɪ n k ʌ m p ə s	ɪ n k ʌ m p ə s t
ɪ n m ɛ ʃ	ɪ n m ɛ ʃ t
ɪ n r ɪ ʧ	ɪ n r ɪ ʧ t
ɪ n s ɛ n s	ɪ n s ɛ n s t
ɪ n s k a n s	ɪ n s k a n s t
ɪ n t aɪ s	ɪ n t aɪ s t
ɪ n t ɚ l a k	ɪ n t ɚ l a k t
ɪ n t ɚ l eɪ s	ɪ n t ɚ l eɪ s t
ɪ n t ɚ s p ɚ s	ɪ n t ɚ s p ɚ s t
ɪ n t r æ n s	ɪ n t r æ n s t
ɪ n t r æ p	ɪ n t r æ p t
ɪ n t r ə d u s	ɪ n t r ə d u s t
ɪ n t r ɛ n ʧ	ɪ n t r ɛ n ʧ t
ɪ n ʧ	ɪ n ʧ t
ɪ n v ɛ l ə p	ɪ n v ɛ l ə p t
ɪ n v oʊ k	ɪ n v oʊ k t
ɪ s k eɪ p	ɪ s k eɪ p t
ɪ s t æ b l ɪ ʃ	ɪ s t æ b l ɪ ʃ t
ɪ ʧ	ɪ ʧ t
ɪ v ɪ n s	ɪ v ɪ n s t
ɪ v oʊ k	ɪ v oʊ k t
j æ ŋ k	j æ ŋ k t
j æ p	j æ p t
j ɛ l p	j ɛ l p t
j u s ɚ p	j u s ɚ p t
k a k	k a k t
k a n v ə l ɛ s	k a n v ə l ɛ s t
k a p	k a p t
k a r p	k a r p t
k æ m p	k æ m p t
k æ p	k æ p t
k æ ʃ	k æ ʃ t
k aʊ n t ə n ə n s	k aʊ n t ə n ə n s t
k aʊ n t ə r ə t æ k	k aʊ n t ə r ə t æ k t
k aʊ n t ɚ b æ l ə n s	k aʊ n t ɚ b æ l ə n s t
k aʊ ʧ	k aʊ ʧ t
k eɪ k	k eɪ k t
k eɪ s	k eɪ s t
k ə l æ p s	k ə l æ p s t
k ə m ɛ n s	k ə m ɛ n s t
k ə m p r ɛ s	k ə m p r ɛ s t
k ə n d ɛ n s	k ə n d ɛ n s t
k ə n f ɛ s	k ə n f ɛ s t
k ə n v ɚ s	k ə n v ɚ s t
k ə n v ɪ n s	k ə n v ɪ n s t
k ə n v ʌ l s	k ə n v ʌ l s t
k ə r ɛ s	k ə r ɛ s t
k ɚ s	k ɚ s t
k ɪ d n æ p	k ɪ d n æ p t
k ɪ k	k ɪ k t
k ɪ s	k ɪ s t
k l a k	k l a k t
k l æ k	k l æ k t
k l æ m p	k l æ m p t
k l æ ŋ k	k l æ ŋ k t
k l æ p	k l æ p t
k l æ s	k l æ s t
k l æ s p	k l æ s p t
k l æ ʃ	k l æ ʃ t
k l aɪ m æ k s	k l aɪ m æ k s t
k l ɛ n ʧ	k l ɛ n ʧ t
k l ɚ r k	k l ɚ r k t
k l ɪ k	k l ɪ k t
k l ɪ n ʧ	k l ɪ n ʧ t
k l ɪ ŋ k	k l ɪ ŋ k t
k l ɪ p	k l ɪ p t
k l oʊ k	k l oʊ k t
k l ʌ k	k l ʌ k t
k l ʌ m p	k l ʌ m p t
k l ʌ ʧ	k l ʌ ʧ t
k oʊ ə l ɛ s	k oʊ ə l ɛ s t
k oʊ ɚ s	k oʊ ɚ s t
k oʊ k s	k oʊ k s t
k oʊ p	k oʊ p t
k oʊ r ə s	k oʊ r ə s t
k oʊ r s	k oʊ r s t
k oʊ ʧ	k oʊ ʧ t
k ɔ f	k ɔ f t
k r a p	k r a p t
k r æ k	k r æ k t
k r æ m p	k r æ m p t
k r æ ŋ k	k r æ ŋ k t
k r æ p	k r æ p t
k r æ ʃ	k r æ ʃ t
k r aʊ ʧ	k r aʊ ʧ t
k r i k	k r i k t
k r i s	k r i s t
k r ɪ m p	k r ɪ m p t
k r ɪ s k r ɔ s	k r ɪ s k r ɔ s t
k r oʊ k	k r oʊ k t
k r ɔ s	k r ɔ s t
k r ʊ k	k r ʊ k t
k r ʌ n ʧ	k r ʌ n ʧ t
k r ʌ ʃ	k r ʌ ʃ t
k ʊ k	k ʊ k t
k ʌ f	k ʌ f t
k ʌ p	k ʌ p t
k ʌ s	k ʌ s t
k w a ʃ	k w a ʃ t
k w eɪ k	k w eɪ k t
k w ɛ n ʧ	k w ɛ n ʧ t
k w ɪ p	k w ɪ p t
l a k	l a k t
l a p	l a p t
l æ f	l æ f t
l æ k	l æ k t
l æ n s	l æ n s t
l æ n s k eɪ p	l æ n s k eɪ p t
l æ ŋ ɡ w ɪ ʃ	l æ ŋ ɡ w ɪ ʃ t
l æ p	l æ p t
l æ p s	l æ p s t
l æ ʃ	l æ ʃ t
l æ ʧ	l æ ʧ t
l aɪ k	l aɪ k t
l aɪ s ə n s	l aɪ s ə n s t
l eɪ s	l eɪ s t
l ɚ k	l ɚ k t
l ɚ n	l ɚ n t
l ɚ ʧ	l ɚ ʧ t
l i f	l i f t
l i k	l i k t
l i s	l i s t
l i ʧ	l i ʧ t
l ɪ k	l ɪ k t
l ɪ m p	l ɪ m p t
l ɪ n ʧ	l ɪ n ʧ t
l ɪ ŋ k	l ɪ ŋ k t
l ɪ s p	l ɪ s p t
l oʊ p	l oʊ p t
l ɔ n ʧ	l ɔ n ʧ t
l u p	l u p t
l u s	l u s t
l ʊ k	l ʊ k t
l ʌ m p	l ʌ m p t
l ʌ n ʧ	l ʌ n ʧ t
m a k	m a k t
m a p	m a p t
m a r k	m a r k t
m a r ʧ	m a r ʧ t
m æ p	m æ p t
m æ s	m æ s t
m æ s k	m æ s k t
m æ ʃ	m æ ʃ t
m æ ʧ	m æ ʧ t
m ɛ n ə s	m ɛ n ə s t
m ɛ s	m ɛ s t
m ɛ ʃ	m ɛ ʃ t
m ɪ k s	m ɪ k s t
m ɪ l k	m ɪ l k t
m ɪ m i ə ɡ r æ f	m ɪ m i ə ɡ r æ f t
m ɪ m ɪ k	m ɪ m ɪ k t
m ɪ n s	m ɪ n s t
m ɪ s	m ɪ s t
m ɪ s p l eɪ s	m ɪ s p l eɪ s t
m u ʧ	m u ʧ t
m ʌ f	m ʌ f t
m ʌ k	m ʌ k t
m ʌ n ʧ	m ʌ n ʧ t
m ʌ s	m ʌ s t
n a k	n a k t
n a n p l ʌ s	n a n p l ʌ s t
n a ʧ	n a ʧ t
n æ p	n æ p t
n æ ʃ	n æ ʃ t
n aɪ f	n aɪ f t
n ɛ k	n ɛ k t
n ɚ ɪ ʃ	n ɚ ɪ ʃ t
n ɚ s	n ɚ s t
n ɪ k	n ɪ k t
n ɪ p	n ɪ p t
n oʊ t ɪ s	n oʊ t ɪ s t
oʊ v ɚ b æ l ə n s	oʊ v ɚ b æ l ə n s t
oʊ v ɚ d r ɛ s	oʊ v ɚ d r ɛ s t
oʊ v ɚ l æ p	oʊ v ɚ l æ p t
oʊ v ɚ l ʊ k	oʊ v ɚ l ʊ k t
oʊ v ɚ s t ɛ p	oʊ v ɚ s t ɛ p t
oʊ v ɚ t æ k s	oʊ v ɚ t æ k s t
oʊ v ɚ w ɚ k	oʊ v ɚ w ɚ k t
ɔ t ə ɡ r æ f	ɔ t ə ɡ r æ f t
p a l ɪ ʃ	p a l ɪ ʃ t
p a p	p a p t
p a r k	p a r k t
p a r ʧ	p a r ʧ t
p æ k	p æ k t
p æ n ɪ k	p æ n ɪ k t
p æ s	p æ s t
p æ ʧ	p æ ʧ t
p aɪ p	p aɪ p t
p aʊ n s	p aʊ n s t
p eɪ r ɪ ʃ	p eɪ r ɪ ʃ t
p eɪ s	p eɪ s t
p ə l i s	p ə l i s t
p ə z ɛ s	p ə z ɛ s t
p ɛ k	p ɛ k t
p ɚ k	p ɚ k t
p ɚ p l ɛ k s	p ɚ p l ɛ k s t
p ɚ s	p ɚ s t
p ɚ ʧ	p ɚ ʧ t
p ɚ ʧ ə s	p ɚ ʧ ə s t
p i k	p i k t
p i k	p i k t
p i k	p i k t
p i p	p i p t
p i r s	p i r s t
p i s	p i s t
p ɪ k	p ɪ k t
p ɪ k n ɪ k	p ɪ k n ɪ k t
p ɪ n ʧ	p ɪ n ʧ t
p ɪ s	p ɪ s t
p ɪ ʧ	p ɪ ʧ t
p j u k	p j u k t
p l a ŋ k	p l a ŋ k t
p l a p	p l a p t
p l eɪ s	p l eɪ s t
p l ʌ k	p l ʌ k t
p l ʌ m p	p l ʌ m p t
p oʊ k	p oʊ k t
p oʊ ʧ	p oʊ ʧ t
p r a m ɪ s	p r a m ɪ s t
p r a p	p r a p t
p r a s ɛ s	p r a s ɛ s t
p r æ k t ɪ s	p r æ k t ɪ s t
p r æ n s	p r æ n s t
p r aɪ s	p r aɪ s t
p r ə d u s	p r ə d u s t
p r ə f ɛ s	p r ə f ɛ s t
p r ə ɡ r ɛ s	p r ə ɡ r ɛ s t
p r ə n aʊ n s	p r ə n aʊ n s t
p r ə v oʊ k	p r ə v oʊ k t
p r ɛ ʤ ʊ d ɪ s	p r ɛ ʤ ʊ d ɪ s t
p r ɛ f ɪ s	p r ɛ f ɪ s t
p r ɛ s	p r ɛ s t
p r i ʧ	p r i ʧ t
p r ɪ k	p r ɪ k t
p ʊ ʃ	p ʊ ʃ t
p ʌ b l ɪ ʃ	p ʌ b l ɪ ʃ t
p ʌ f	p ʌ f t
p ʌ l p	p ʌ l p t
p ʌ l s	p ʌ l s t
p ʌ m p	p ʌ m p t
p ʌ n ɪ ʃ	p ʌ n ɪ ʃ t
p ʌ n ʧ	p ʌ n ʧ t
r a k	r a k t
r a m p	r a m p t
r æ k	r æ k t
r æ n s æ k	r æ n s æ k t
r æ ŋ k	r æ ŋ k t
r æ p	r æ p t
r æ p	r æ p t
r æ s p	r æ s p t
r æ v ɪ ʃ	r æ v ɪ ʃ t
r eɪ k	r eɪ k t
r eɪ p	r eɪ p t
r eɪ s	r eɪ s t
r ɛ k	r ɛ k t
r ɛ l ɪ ʃ	r ɛ l ɪ ʃ t
r ɛ m ɪ n ɪ s	r ɛ m ɪ n ɪ s t
r ɛ n ʧ	r ɛ n ʧ t
r ɛ ʧ	r ɛ ʧ t
r i d r ɛ s	r i d r ɛ s t
r i f ɚ b ɪ ʃ	r i f ɚ b ɪ ʃ t
r i ɡ r u p	r i ɡ r u p t
r i ɪ m b ɚ s	r i ɪ m b ɚ s t
r i ɪ n f oʊ r s	r i ɪ n f oʊ r s t
r i k	r i k t
r i k	r i k t
r i p	r i p t
r i p r ə d u s	r i p r ə d u s t
r i s ɚ f ɪ s	r i s ɚ f ɪ s t
r i s ɚ ʧ	r i s ɚ ʧ t
r i s t a k	r i s t a k t
r i t ʌ ʧ	r i t ʌ ʧ t
r i ʧ	r i ʧ t
r i v æ m p	r i v æ m p t
r ɪ b j u k	r ɪ b j u k t
r ɪ b ʌ f	r ɪ b ʌ f t
r ɪ d u s	r ɪ d u s t
r ɪ ʤ ɔɪ s	r ɪ ʤ ɔɪ s t
r ɪ f r ɛ ʃ	r ɪ f r ɛ ʃ t
r ɪ ɡ r ɛ s	r ɪ ɡ r ɛ s t
r ɪ h ɚ s	r ɪ h ɚ s t
r ɪ k u p	r ɪ k u p t
r ɪ l æ k s	r ɪ l æ k s t
r ɪ l æ p s	r ɪ l æ p s t
r ɪ l i s	r ɪ l i s t
r ɪ l ɪ ŋ k w ɪ ʃ	r ɪ l ɪ ŋ k w ɪ ʃ t
r ɪ m a r k	r ɪ m a r k t
r ɪ n aʊ n s	r ɪ n aʊ n s t
r ɪ n s	r ɪ n s t
r ɪ p	r ɪ p t
r ɪ p l eɪ s	r ɪ p l eɪ s t
r ɪ p l ɛ n ɪ ʃ	r ɪ p l ɛ n ɪ ʃ t
r ɪ p r ɛ s	r ɪ p r ɛ s t
r ɪ p r oʊ ʧ	r ɪ p r oʊ ʧ t
r ɪ p ʌ l s	r ɪ p ʌ l s t
r ɪ s ɛ s	r ɪ s ɛ s t
r ɪ s k	r ɪ s k t
r ɪ t r eɪ s	r ɪ t r eɪ s t
r ɪ v ɚ s	r ɪ v ɚ s t
r ɪ v oʊ k	r ɪ v oʊ k t
r oʊ p	r oʊ p t
r u f	r u f t
r ʌ b ɚ s t æ m p	r ʌ b ɚ s t æ m p t
r ʌ f	r ʌ f t
r ʌ ʃ	r ʌ ʃ t
s a k	s a k t
s æ k	s æ k t
s æ k r ə f aɪ s	s æ k r ə f aɪ s t
s æ n d w ɪ ʧ	s æ n d w ɪ ʧ t
s æ p	s æ p t
s aɪ d s t ɛ p	s aɪ d s t ɛ p t
s aɪ d t r æ k	s aɪ d t r æ k t
s aɪ l ə n s	s aɪ l ə n s t
s ə f aɪ s	s ə f aɪ s t
s ə p r ɛ s	s ə p r ɛ s t
s ɛ n s	s ɛ n s t
s ɛ n t ə n s	s ɛ n t ə n s t
s ɚ f ɪ s	s ɚ f ɪ s t
s ɚ p æ s	s ɚ p æ s t
s ɚ ʧ	s ɚ ʧ t
s ɚ v ɪ s	s ɚ v ɪ s t
s i p	s i p t
s i s	s i s t
s ɪ d u s	s ɪ d u s t
s ɪ p	s ɪ p t
s k a l ə p	s k a l ə p t
s k a ʧ	s k a ʧ t
s k æ l p	s k æ l p t
s k ɛ ʧ	s k ɛ ʧ t
s k ɚ m ɪ ʃ	s k ɚ m ɪ ʃ t
s k ɪ m p	s k ɪ m p t
s k ɪ p	s k ɪ p t
s k oʊ r ʧ	s k oʊ r ʧ t
s k ɔ f	s k ɔ f t
s k r æ p	s k r æ p t
s k r æ ʧ	s k r æ ʧ t
s k r eɪ p	s k r eɪ p t
s k r i ʧ	s k r i ʧ t
s k r ʌ n ʧ	s k r ʌ n ʧ t
s k u p	s k u p t
s k ʌ f	s k ʌ f t
s k ʌ l k	s k ʌ l k t
s k w ɛ l ʧ	s k w ɛ l ʧ t
s k w i k	s k w i k t
s k w ɔ k	s k w ɔ k t
s k w ɔ ʃ	s k w ɔ ʃ t
s l a p	s l a p t
s l a ʃ	s l a ʃ t
s l æ p	s l æ p t
s l æ ʃ	s l æ ʃ t
s l aɪ s	s l aɪ s t
s l aʊ ʧ	s l aʊ ʧ t
s l eɪ k	s l eɪ k t
s l ɚ p	s l ɚ p t
s l ɪ p	s l ɪ p t
s l oʊ p	s l oʊ p t
s l ʌ m p	s l ʌ m p t
s m æ k	s m æ k t
s m æ ʃ	s m æ ʃ t
s m ɛ l	s m ɛ l t
s m ɚ k	s m ɚ k t
s m oʊ k	s m oʊ k t
s n æ p	s n æ p t
s n æ ʧ	s n æ ʧ t
s n aɪ p	s n aɪ p t
s n eɪ k	s n eɪ k t
s n ɪ f	s n ɪ f t
s n ɪ p	s n ɪ p t
s n u p	s n u p t
s n ʌ f	s n ʌ f t
s oʊ k	s oʊ k t
s oʊ p	s oʊ p t
s p a r k	s p a r k t
s p æ ŋ k	s p æ ŋ k t
s p aɪ k	s p aɪ k t
s p aɪ s	s p aɪ s t
s p eɪ s	s p eɪ s t
s p ɛ l	s p ɛ l t
s p ɪ l	s p ɪ l t
s p l æ ʃ	s p l æ ʃ t
s p l aɪ s	s p l aɪ s t
s p ɔɪ l	s p ɔɪ l t
s p u k	s p u k t
s t a k	s t a k t
s t a m p	s t a m p t
s t a p	s t a p t
s t a r ʧ	s t a r ʧ t
s t æ f	s t æ f t
s t æ k	s t æ k t
s t æ m p	s t æ m p t
s t æ ʃ	s t æ ʃ t
s t eɪ k	s t eɪ k t
s t eɪ r i oʊ t aɪ p	s t eɪ r i oʊ t aɪ p t
s t ɛ p	s t ɛ p t
s t i p	s t i p t
s t ɪ ʧ	s t ɪ ʧ t
s t oʊ k	s t oʊ k t
s t ɔ k	s t ɔ k t
s t ɔ n ʧ	s t ɔ n ʧ t
s t r æ p	s t r æ p t
s t r eɪ f	s t r eɪ f t
s t r ɛ s	s t r ɛ s t
s t r ɛ ʧ	s t r ɛ ʧ t
s t r i k	s t r i k t
s t r ɪ p	s t r ɪ p t
s t r oʊ k	s t r oʊ k t
s t u p	s t u p t
s t ʌ f	s t ʌ f t
s t ʌ m ə k	s t ʌ m ə k t
s t ʌ m p	s t ʌ m p t
s ʌ k	s ʌ k t
s ʌ l k	s ʌ l k t
s ʌ p	s ʌ p t
s w a m p	s w a m p t
s w a p	s w a p t
s w aɪ p	s w aɪ p t
s w ɪ ʃ	s w ɪ ʃ t
s w ɪ ʧ	s w ɪ ʧ t
s w u p	s w u p t
ʃ a k	ʃ a k t
ʃ a p	ʃ a p t
ʃ eɪ p	ʃ eɪ p t
ʃ ɚ k	ʃ ɚ k t
ʃ ɪ p	ʃ ɪ p t
ʃ ɪ p r ɛ k	ʃ ɪ p r ɛ k t
ʃ r i k	ʃ r i k t
ʃ r ɪ m p	ʃ r ɪ m p t
ʃ ʊ ʃ	ʃ ʊ ʃ t
t a p	t a p t
t a r n ɪ ʃ	t a r n ɪ ʃ t
t æ k	t æ k t
t æ k s	t æ k s t
t æ m p	t æ m p t
t æ p	t æ p t
t aɪ p	t aɪ p t
t eɪ p	t eɪ p t
t eɪ r ə s	t eɪ r ə s t
t ɛ l ɛ k s	t ɛ l ɛ k s t
t ɛ l ɪ ɡ r æ f	t ɛ l ɪ ɡ r æ f t
t ɛ l ɪ s k oʊ p	t ɛ l ɪ s k oʊ p t
t ɛ n s	t ɛ n s t
t ɪ k	t ɪ k t
t ɪ p	t ɪ p t
t ɔ k	t ɔ k t
t ɔ s	t ɔ s t
t r æ f ɪ k	t r æ f ɪ k t
t r æ k	t r æ k t
t r æ m p	t r æ m p t
t r æ n s f ɪ k s	t r æ n s f ɪ k s t
t r æ n s ɡ r ɛ s	t r æ n s ɡ r ɛ s t
t r æ p	t r æ p t
t r aɪ ə m f	t r aɪ ə m f t
t r aʊ n s	t r aʊ n s t
t r eɪ p s	t r eɪ p s t
t r eɪ s	t r eɪ s t
t r ə v ɚ s	t r ə v ɚ s t
t r ɛ k	t r ɛ k t
t r ɛ s p æ s	t r ɛ s p æ s t
t r ɪ k	t r ɪ k t
t r ɪ p	t r ɪ p t
t r u p	t r u p t
t r ʌ s	t r ʌ s t
t ʌ k	t ʌ k t
t ʌ ʧ	t ʌ ʧ t
t w i k	t w i k t
t w ɪ ʧ	t w ɪ ʧ t
ʧ a m p	ʧ a m p t
ʧ a p	ʧ a p t
ʧ æ f	ʧ æ f t
ʧ æ n s	ʧ æ n s t
ʧ æ p	ʧ æ p t
ʧ eɪ f	ʧ eɪ f t
ʧ eɪ n s m oʊ k	ʧ eɪ n s m oʊ k t
ʧ eɪ r ɪ ʃ	ʧ eɪ r ɪ ʃ t
ʧ eɪ s	ʧ eɪ s t
ʧ ɛ k	ʧ ɛ k t
ʧ ɚ p	ʧ ɚ p t
ʧ i k	ʧ i k t
ʧ ɪ p	ʧ ɪ p t
ʧ oʊ k	ʧ oʊ k t
ʧ ɔ k	ʧ ɔ k t
ʧ ʌ k	ʧ ʌ k t
v a r n ɪ ʃ	v a r n ɪ ʃ t
v æ n ɪ ʃ	v æ n ɪ ʃ t
v æ ŋ k w ɪ ʃ	v æ ŋ k w ɪ ʃ t
v aʊ ʧ s eɪ f	v aʊ ʧ s eɪ f t
v ɛ k s	v ɛ k s t
v ɔɪ s	v ɔɪ s t
ʌ n b æ l ə n s	ʌ n b æ l ə n s t
ʌ n d r ɛ s	ʌ n d r ɛ s t
ʌ n ɚ θ	ʌ n ɚ θ t
ʌ n h ʊ k	ʌ n h ʊ k t
ʌ n l a k	ʌ n l a k t
ʌ n l i ʃ	ʌ n l i ʃ t
ʌ n m æ s k	ʌ n m æ s k t
ʌ n p æ k	ʌ n p æ k t
ʌ n z ɪ p	ʌ n z ɪ p t
ʌ p	ʌ p t
w a l ə p	w a l ə p t
w a ʧ	w a ʧ t
w æ k	w æ k t
w æ k s	w æ k s t
w aɪ p	w aɪ p t
w aɪ t w ɔ ʃ	w aɪ t w ɔ ʃ t
w ɛ l ʃ	w ɛ l ʃ t
w ɚ k	w ɚ k t
w ɚ ʃ ɪ p	w ɚ ʃ ɪ p t
w ɪ n s	w ɪ n s t
w ɪ n ʧ	w ɪ n ʧ t
w ɪ ŋ k	w ɪ ŋ k t
w ɪ p	w ɪ p t
w ɪ s k	w ɪ s k t
w ɪ ʃ	w ɪ ʃ t
w ɪ t n ɪ s	w ɪ t n ɪ s t
w oʊ r p	w oʊ r p t
w ɔ k	w ɔ k t
w ɔ l s	w ɔ l s t
w ɔ ʃ	w ɔ ʃ t
w u p	w u p t
w ʊ l f	w ʊ l f t
z æ p	z æ p t
z i r a k s	z i r a k s t
z ɪ p	z ɪ p t
θ æ ŋ k	θ æ ŋ k t
θ æ ʧ	θ æ ʧ t
θ r æ ʃ	θ r æ ʃ t
θ r ɛ ʃ	θ r ɛ ʃ t
θ ʌ m p	θ ʌ m p t











a b l ɪ ɡ eɪ t	a b l ɪ ɡ eɪ t ə d
a b v i eɪ t	a b v i eɪ t ə d
a k s ɪ ʤ ə n eɪ t	a k s ɪ ʤ ə n eɪ t ə d
a p ə r eɪ t	a p ə r eɪ t ə d
a r t ɪ k j ʊ l eɪ t	a r t ɪ k j ʊ l eɪ t ə d
a s ɪ l eɪ t	a s ɪ l eɪ t ə d
æ b d ɪ k eɪ t	æ b d ɪ k eɪ t ə d
æ b r ə ɡ eɪ t	æ b r ə ɡ eɪ t ə d
æ b s ɛ n t	æ b s ɛ n t ə d
æ b s t r æ k t	æ b s t r æ k t ə d
æ d	æ d ə d
æ d v ə k eɪ t	æ d v ə k eɪ t ə d
æ ʤ ɪ t eɪ t	æ ʤ ɪ t eɪ t ə d
æ ɡ r ə v eɪ t	æ ɡ r ə v eɪ t ə d
æ ɡ r ɪ ɡ eɪ t	æ ɡ r ɪ ɡ eɪ t ə d
æ k s ɛ n t	æ k s ɛ n t ə d
æ k s ɛ n ʧ u eɪ t	æ k s ɛ n ʧ u eɪ t ə d
æ k s i d	æ k s i d ə d
æ k t	æ k t ə d
æ k t ə v eɪ t	æ k t ə v eɪ t ə d
æ l ə k eɪ t	æ l ə k eɪ t ə d
æ m p j ʊ t eɪ t	æ m p j ʊ t eɪ t ə d
æ n ɪ m eɪ t	æ n ɪ m eɪ t ə d
æ n oʊ t eɪ t	æ n oʊ t eɪ t ə d
æ n t ɪ d eɪ t	æ n t ɪ d eɪ t ə d
æ n t ɪ s ə p eɪ t	æ n t ɪ s ə p eɪ t ə d
æ p r ɪ h ɛ n d	æ p r ɪ h ɛ n d ə d
æ s f æ l t	æ s f æ l t ə d
aɪ s ə l eɪ t	aɪ s ə l eɪ t ə d
aʊ s t	aʊ s t ə d
aʊ t	aʊ t ə d
aʊ t l æ s t	aʊ t l æ s t ə d
aʊ t w ɪ t	aʊ t w ɪ t ə d
b a m b a r d	b a m b a r d ə d
b a n d	b a n d ə d
b æ l ə t	b æ l ə t ə d
b æ n d	b æ n d ə d
b æ ŋ k r ʌ p t	b æ ŋ k r ʌ p t ə d
b æ ŋ k w ɪ t	b æ ŋ k w ɪ t ə d
b æ t	b æ t ə d
b aɪ d	b aɪ d ə d
b aɪ s ɛ k t	b aɪ s ɛ k t ə d
b aʊ n d	b aʊ n d ə d
b eɪ ə n ɛ t	b eɪ ə n ɛ t ə d
b eɪ r ɪ k eɪ d	b eɪ r ɪ k eɪ d ə d
b eɪ s t	b eɪ s t ə d
b eɪ t	b eɪ t ə d
b eɪ t	b eɪ t ə d
b ɛ d	b ɛ d ə d
b ɛ l t	b ɛ l t ə d
b ɛ n ə f ɪ t	b ɛ n ə f ɪ t ə d
b i d	b i d ə d
b i r eɪ t	b i r eɪ t ə d
b ɪ f ɪ t	b ɪ f ɪ t ə d
b ɪ f r ɛ n d	b ɪ f r ɛ n d ə d
b ɪ h ɛ d	b ɪ h ɛ d ə d
b ɪ l ɪ t	b ɪ l ɪ t ə d
b l a k eɪ d	b l a k eɪ d ə d
b l a t	b l a t ə d
b l æ ŋ k ɪ t	b l æ ŋ k ɪ t ə d
b l æ s t	b l æ s t ə d
b l aɪ n d	b l aɪ n d ə d
b l aɪ n d f oʊ l d	b l aɪ n d f oʊ l d ə d
b l aɪ t	b l aɪ t ə d
b l ɛ n d	b l ɛ n d ə d
b l i t	b l i t ə d
b l oʊ t	b l oʊ t ə d
b l ʌ d	b l ʌ d ə d
b l ʌ n t	b l ʌ n t ə d
b oʊ d	b oʊ d ə d
b oʊ l t	b oʊ l t ə d
b oʊ r d	b oʊ r d ə d
b oʊ s t	b oʊ s t ə d
b oʊ t	b oʊ t ə d
b ɔɪ k a t	b ɔɪ k a t ə d
b r æ k ɪ t	b r æ k ɪ t ə d
b r æ n d	b r æ n d ə d
b r eɪ d	b r eɪ d ə d
b r ɛ k f ə s t	b r ɛ k f ə s t ə d
b r ɔ d k æ s t	b r ɔ d k æ s t ə d
b r u d	b r u d ə d
b u s t	b u s t ə d
b ʌ d	b ʌ d ə d
b ʌ ʤ ɪ t	b ʌ ʤ ɪ t ə d
b ʌ f ɪ t	b ʌ f ɪ t ə d
b ʌ s t	b ʌ s t ə d
b ʌ t	b ʌ t ə d
d a k j ʊ m ɛ n t	d a k j ʊ m ɛ n t ə d
d a m ɪ n eɪ t	d a m ɪ n eɪ t ə d
d a r t	d a r t ə d
d a t	d a t ə d
d aɪ ə t	d aɪ ə t ə d
d aɪ l eɪ t	d aɪ l eɪ t ə d
d aɪ l u t	d aɪ l u t ə d
d aɪ n ə m aɪ t	d aɪ n ə m aɪ t ə d
d aɪ r ɛ k t	d aɪ r ɛ k t ə d
d aɪ v ɚ t	d aɪ v ɚ t ə d
d aʊ n ɡ r eɪ d	d aʊ n ɡ r eɪ d ə d
d aʊ t	d aʊ t ə d
d eɪ t	d eɪ t ə d
d ə m ɛ s t ɪ k eɪ t	d ə m ɛ s t ɪ k eɪ t ə d
d ɛ b ɪ t	d ɛ b ɪ t ə d
d ɛ d ɪ k eɪ t	d ɛ d ɪ k eɪ t ə d
d ɛ f ə k eɪ t	d ɛ f ə k eɪ t ə d
d ɛ k ə r eɪ t	d ɛ k ə r eɪ t ə d
d ɛ l ɪ ɡ eɪ t	d ɛ l ɪ ɡ eɪ t ə d
d ɛ m ə n s t r eɪ t	d ɛ m ə n s t r eɪ t ə d
d ɛ n ɪ ɡ r eɪ t	d ɛ n ɪ ɡ r eɪ t ə d
d ɛ n t	d ɛ n t ə d
d ɛ p r ɪ k eɪ t	d ɛ p r ɪ k eɪ t ə d
d ɛ s ə l eɪ t	d ɛ s ə l eɪ t ə d
d ɛ s ɪ k eɪ t	d ɛ s ɪ k eɪ t ə d
d ɛ s ɪ k r eɪ t	d ɛ s ɪ k r eɪ t ə d
d ɛ s ɪ m eɪ t	d ɛ s ɪ m eɪ t ə d
d ɛ t ə n eɪ t	d ɛ t ə n eɪ t ə d
d ɛ v ə s t eɪ t	d ɛ v ə s t eɪ t ə d
d ɛ z ɪ ɡ n eɪ t	d ɛ z ɪ ɡ n eɪ t ə d
d i ʤ ɛ n ɚ eɪ t	d i ʤ ɛ n ɚ eɪ t ə d
d i f r ɔ s t	d i f r ɔ s t ə d
d i h aɪ d r eɪ t	d i h aɪ d r eɪ t ə d
d i k oʊ d	d i k oʊ d ə d
d i m oʊ t	d i m oʊ t ə d
d i p a p j ʊ l eɪ t	d i p a p j ʊ l eɪ t ə d
d i r aɪ d	d i r aɪ d ə d
d i s ɛ l ə r eɪ t	d i s ɛ l ə r eɪ t ə d
d i v i eɪ t	d i v i eɪ t ə d
d ɪ b eɪ t	d ɪ b eɪ t ə d
d ɪ b ɪ l ɪ t eɪ t	d ɪ b ɪ l ɪ t eɪ t ə d
d ɪ d ʌ k t	d ɪ d ʌ k t ə d
d ɪ ʤ ɛ s t	d ɪ ʤ ɛ s t ə d
d ɪ ɚ ɛ n ʧ i eɪ t	d ɪ ɚ ɛ n ʧ i eɪ t ə d
d ɪ f ɛ k t	d ɪ f ɛ k t ə d
d ɪ f ɛ n d	d ɪ f ɛ n d ə d
d ɪ f i t	d ɪ f i t ə d
d ɪ f l eɪ t	d ɪ f l eɪ t ə d
d ɪ f l ɛ k t	d ɪ f l ɛ k t ə d
d ɪ f ɔ l t	d ɪ f ɔ l t ə d
d ɪ f r ɔ d	d ɪ f r ɔ d ə d
d ɪ ɡ r eɪ d	d ɪ ɡ r eɪ d ə d
d ɪ k æ n t	d ɪ k æ n t ə d
d ɪ k æ p ɪ t eɪ t	d ɪ k æ p ɪ t eɪ t ə d
d ɪ k t eɪ t	d ɪ k t eɪ t ə d
d ɪ l aɪ t	d ɪ l aɪ t ə d
d ɪ l i t	d ɪ l i t ə d
d ɪ l ɪ b ɚ eɪ t	d ɪ l ɪ b ɚ eɪ t ə d
d ɪ l ɪ n i eɪ t	d ɪ l ɪ n i eɪ t ə d
d ɪ l u d	d ɪ l u d ə d
d ɪ m æ n d	d ɪ m æ n d ə d
d ɪ n oʊ t	d ɪ n oʊ t ə d
d ɪ n u d	d ɪ n u d ə d
d ɪ p a r t	d ɪ p a r t ə d
d ɪ p a z ɪ t	d ɪ p a z ɪ t ə d
d ɪ p ɛ n d	d ɪ p ɛ n d ə d
d ɪ p ɪ k t	d ɪ p ɪ k t ə d
d ɪ p l i t	d ɪ p l i t ə d
d ɪ p oʊ r t	d ɪ p oʊ r t ə d
d ɪ p r i ʃ i eɪ t	d ɪ p r i ʃ i eɪ t ə d
d ɪ s aɪ d	d ɪ s aɪ d ə d
d ɪ s b æ n d	d ɪ s b æ n d ə d
d ɪ s ə p ɔɪ n t	d ɪ s ə p ɔɪ n t ə d
d ɪ s ə s oʊ s i eɪ t	d ɪ s ə s oʊ s i eɪ t ə d
d ɪ s ɛ k t	d ɪ s ɛ k t ə d
d ɪ s ɛ m ɪ n eɪ t	d ɪ s ɛ m ɪ n eɪ t ə d
d ɪ s ɛ n d	d ɪ s ɛ n d ə d
d ɪ s ɛ n t	d ɪ s ɛ n t ə d
d ɪ s ɡ ʌ s t	d ɪ s ɡ ʌ s t ə d
d ɪ s ɪ n f ɛ k t	d ɪ s ɪ n f ɛ k t ə d
d ɪ s ɪ n h eɪ r ɪ t	d ɪ s ɪ n h eɪ r ɪ t ə d
d ɪ s ɪ n t ə ɡ r eɪ t	d ɪ s ɪ n t ə ɡ r eɪ t ə d
d ɪ s ɪ n ʧ æ n t	d ɪ s ɪ n ʧ æ n t ə d
d ɪ s ɪ p eɪ t	d ɪ s ɪ p eɪ t ə d
d ɪ s k a r d	d ɪ s k a r d ə d
d ɪ s k aʊ n t	d ɪ s k aʊ n t ə d
d ɪ s k ə n ɛ k t	d ɪ s k ə n ɛ k t ə d
d ɪ s k ə n s ɚ t	d ɪ s k ə n s ɚ t ə d
d ɪ s k r ɛ d ɪ t	d ɪ s k r ɛ d ɪ t ə d
d ɪ s k r ɪ m ɪ n eɪ t	d ɪ s k r ɪ m ɪ n eɪ t ə d
d ɪ s k ʌ m f ɪ t	d ɪ s k ʌ m f ɪ t ə d
d ɪ s k w aɪ ə t	d ɪ s k w aɪ ə t ə d
d ɪ s l oʊ k eɪ t	d ɪ s l oʊ k eɪ t ə d
d ɪ s m aʊ n t	d ɪ s m aʊ n t ə d
d ɪ s oʊ r i ə n t	d ɪ s oʊ r i ə n t ə d
d ɪ s oʊ r i ə n t eɪ t	d ɪ s oʊ r i ə n t eɪ t ə d
d ɪ s oʊ ʃ i eɪ t	d ɪ s oʊ ʃ i eɪ t ə d
d ɪ s p i r ɪ t	d ɪ s p i r ɪ t ə d
d ɪ s p j u t	d ɪ s p j u t ə d
d ɪ s p oʊ r t	d ɪ s p oʊ r t ə d
d ɪ s r ɪ ɡ a r d	d ɪ s r ɪ ɡ a r d ə d
d ɪ s r ʌ p t	d ɪ s r ʌ p t ə d
d ɪ s t ɛ n d	d ɪ s t ɛ n d ə d
d ɪ s t oʊ r t	d ɪ s t oʊ r t ə d
d ɪ s t r æ k t	d ɪ s t r æ k t ə d
d ɪ s t r ɪ b j u t	d ɪ s t r ɪ b j u t ə d
d ɪ s t r ʌ s t	d ɪ s t r ʌ s t ə d
d ɪ s w eɪ d	d ɪ s w eɪ d ə d
d ɪ t ɛ k t	d ɪ t ɛ k t ə d
d ɪ t ɛ s t	d ɪ t ɛ s t ə d
d ɪ t i r i ə r eɪ t	d ɪ t i r i ə r eɪ t ə d
d ɪ v aɪ d	d ɪ v aɪ d ə d
d ɪ z ɚ t	d ɪ z ɚ t ə d
d ɪ z ɪ s t	d ɪ z ɪ s t ə d
d oʊ n eɪ t	d oʊ n eɪ t ə d
d ɔ n t	d ɔ n t ə d
d r æ f t	d r æ f t ə d
d r æ t	d r æ t ə d
d r ɛ d	d r ɛ d ə d
d r ɪ f t	d r ɪ f t ə d
d u p l ɪ k eɪ t	d u p l ɪ k eɪ t ə d
d ʌ m f aʊ n d	d ʌ m f aʊ n d ə d
d ʌ s t	d ʌ s t ə d
ʤ a t	ʤ a t ə d
ʤ aɪ r eɪ t	ʤ aɪ r eɪ t ə d
ʤ ɛ n ə r eɪ t	ʤ ɛ n ə r eɪ t ə d
ʤ ɛ n j u f l ɛ k t	ʤ ɛ n j u f l ɛ k t ə d
ʤ ɛ s t ɪ k j ʊ l eɪ t	ʤ ɛ s t ɪ k j ʊ l eɪ t ə d
ʤ ɛ t	ʤ ɛ t ə d
ʤ ɚ m ə n eɪ t	ʤ ɚ m ə n eɪ t ə d
ʤ ɪ l t	ʤ ɪ l t ə d
ʤ oʊ l t	ʤ oʊ l t ə d
ʤ ɔɪ n t	ʤ ɔɪ n t ə d
eɪ d	eɪ d ə d
eɪ l i ə n eɪ t	eɪ l i ə n eɪ t ə d
eɪ r eɪ t	eɪ r eɪ t ə d
eɪ r ə ɡ eɪ t	eɪ r ə ɡ eɪ t ə d
ə b aɪ d	ə b aɪ d ə d
ə b aʊ n d	ə b aʊ n d ə d
ə b d ʌ k t	ə b d ʌ k t ə d
ə b ʤ ɛ k t	ə b ʤ ɛ k t ə d
ə b eɪ t	ə b eɪ t ə d
ə b ɛ t	ə b ɛ t ə d
ə b l ɪ t ə r eɪ t	ə b l ɪ t ə r eɪ t ə d
ə b oʊ r t	ə b oʊ r t ə d
ə b r i v i eɪ t	ə b r i v i eɪ t ə d
ə b s t r ʌ k t	ə b s t r ʌ k t ə d
ə b t r u d	ə b t r u d ə d
ə d a p t	ə d a p t ə d
ə d æ p t	ə d æ p t ə d
ə d ɪ k t	ə d ɪ k t ə d
ə d m ɪ t	ə d m ɪ t ə d
ə d ʌ l t ə r eɪ t	ə d ʌ l t ə r eɪ t ə d
ə ʤ u d ɪ k eɪ t	ə ʤ u d ɪ k eɪ t ə d
ə ʤ ʌ s t	ə ʤ ʌ s t ə d
ə f ɛ k t	ə f ɛ k t ə d
ə f ɛ n d	ə f ɛ n d ə d
ə f ɪ l i eɪ t	ə f ɪ l i eɪ t ə d
ə f ɪ ʃ i eɪ t	ə f ɪ ʃ i eɪ t ə d
ə f l ɪ k t	ə f l ɪ k t ə d
ə f oʊ r d	ə f oʊ r d ə d
ə f r ʌ n t	ə f r ʌ n t ə d
ə k a m ə d eɪ t	ə k a m ə d eɪ t ə d
ə k aʊ n t	ə k aʊ n t ə d
ə k j u m j ə l eɪ t	ə k j u m j ə l eɪ t ə d
ə k oʊ r d	ə k oʊ r d ə d
ə k ɔ s t	ə k ɔ s t ə d
ə k r ɛ d ɪ t	ə k r ɛ d ɪ t ə d
ə k s ɛ l ə r eɪ t	ə k s ɛ l ə r eɪ t ə d
ə k s ɛ p t	ə k s ɛ p t ə d
ə k w ɪ t	ə k w ɪ t ə d
ə l a t	ə l a t ə d
ə l aɪ t	ə l aɪ t ə d
ə l ɚ t	ə l ɚ t ə d
ə l i v i eɪ t	ə l i v i eɪ t ə d
ə m æ l ɡ ə m eɪ t	ə m æ l ɡ ə m eɪ t ə d
ə m ɛ n d	ə m ɛ n d ə d
ə m i l j ə r eɪ t	ə m i l j ə r eɪ t ə d
ə n aɪ ə l eɪ t	ə n aɪ ə l eɪ t ə d
ə n ɔɪ n t	ə n ɔɪ n t ə d
ə p ɛ n d	ə p ɛ n d ə d
ə p l ɔ d	ə p l ɔ d ə d
ə p ɔɪ n t	ə p ɔɪ n t ə d
ə p r a k s ɪ m eɪ t	ə p r a k s ɪ m eɪ t ə d
ə p r i ʃ i eɪ t	ə p r i ʃ i eɪ t ə d
ə p r oʊ p r i eɪ t	ə p r oʊ p r i eɪ t ə d
ə r ɛ s t	ə r ɛ s t ə d
ə r ɪ ʤ ə n eɪ t	ə r ɪ ʤ ə n eɪ t ə d
ə s æ s ɪ n eɪ t	ə s æ s ɪ n eɪ t ə d
ə s ɛ n d	ə s ɛ n d ə d
ə s ɛ n t	ə s ɛ n t ə d
ə s ɚ t	ə s ɚ t ə d
ə s ɪ m ə l eɪ t	ə s ɪ m ə l eɪ t ə d
ə s ɪ s t	ə s ɪ s t ə d
ə s oʊ r t	ə s oʊ r t ə d
ə s oʊ s i eɪ t	ə s oʊ s i eɪ t ə d
ə s ɔ l t	ə s ɔ l t ə d
ə s t aʊ n d	ə s t aʊ n d ə d
ə t ɛ m p t	ə t ɛ m p t ə d
ə t ɛ n d	ə t ɛ n d ə d
ə t ɛ n j u eɪ t	ə t ɛ n j u eɪ t ə d
ə t ɛ s t	ə t ɛ s t ə d
ə t r æ k t	ə t r æ k t ə d
ə v ɚ t	ə v ɚ t ə d
ə v ɔɪ d	ə v ɔɪ d ə d
ə w eɪ t	ə w eɪ t ə d
ə w oʊ r d	ə w oʊ r d ə d
ɛ d ɪ t	ɛ d ɪ t ə d
ɛ ʤ ə k eɪ t	ɛ ʤ ə k eɪ t ə d
ɛ ɡ z ɪ t	ɛ ɡ z ɪ t ə d
ɛ k s ə k j u t	ɛ k s ə k j u t ə d
ɛ k s k ə m j u n ɪ k eɪ t	ɛ k s k ə m j u n ɪ k eɪ t ə d
ɛ k s k ə v eɪ t	ɛ k s k ə v eɪ t ə d
ɛ k s p r oʊ p r i eɪ t	ɛ k s p r oʊ p r i eɪ t ə d
ɛ k s t r ə d aɪ t	ɛ k s t r ə d aɪ t ə d
ɛ k s t r ə k eɪ t	ɛ k s t r ə k eɪ t ə d
ɛ l ɪ v eɪ t	ɛ l ɪ v eɪ t ə d
ɛ m ɪ ɡ r eɪ t	ɛ m ɪ ɡ r eɪ t ə d
ɛ m j ə l eɪ t	ɛ m j ə l eɪ t ə d
ɛ n d	ɛ n d ə d
ɛ n ɚ v eɪ t	ɛ n ɚ v eɪ t ə d
ɛ n k oʊ d	ɛ n k oʊ d ə d
ɛ s k ə l eɪ t	ɛ s k ə l eɪ t ə d
ɛ s t ə m eɪ t	ɛ s t ə m eɪ t ə d
f a r t	f a r t ə d
f æ b r ɪ k eɪ t	f æ b r ɪ k eɪ t ə d
f æ s ə n eɪ t	f æ s ə n eɪ t ə d
f æ s t	f æ s t ə d
f æ t	f æ t ə d
f aʊ n d	f aʊ n d ə d
f eɪ d	f eɪ d ə d
f eɪ n t	f eɪ n t ə d
f eɪ n t	f eɪ n t ə d
f eɪ r ɪ t	f eɪ r ɪ t ə d
f ə s ɪ l ə t eɪ t	f ə s ɪ l ə t eɪ t ə d
f ɛ n d	f ɛ n d ə d
f ɚ m ɛ n t	f ɚ m ɛ n t ə d
f i l d	f i l d ə d
f i s t	f i s t ə d
f ɪ ʤ ɪ t	f ɪ ʤ ɪ t ə d
f ɪ k s eɪ t	f ɪ k s eɪ t ə d
f ɪ ŋ ɡ ɚ p r ɪ n t	f ɪ ŋ ɡ ɚ p r ɪ n t ə d
f l æ b ɚ ɡ æ s t	f l æ b ɚ ɡ æ s t ə d
f l aʊ t	f l aʊ t ə d
f l ɚ t	f l ɚ t ə d
f l ɪ t	f l ɪ t ə d
f l oʊ t	f l oʊ t ə d
f l ɔ n t	f l ɔ n t ə d
f l u t	f l u t ə d
f l ʌ d	f l ʌ d ə d
f l ʌ d l aɪ t	f l ʌ d l aɪ t ə d
f l ʌ k ʧ u eɪ t	f l ʌ k ʧ u eɪ t ə d
f oʊ l d	f oʊ l d ə d
f oʊ r d	f oʊ r d ə d
f oʊ r f ɪ t	f oʊ r f ɪ t ə d
f oʊ r m j ʊ l eɪ t	f oʊ r m j ʊ l eɪ t ə d
f oʊ r w ə d	f oʊ r w ə d ə d
f ɔ l t	f ɔ l t ə d
f r æ ɡ m ɛ n t	f r æ ɡ m ɛ n t ə d
f r ɛ t	f r ɛ t ə d
f r ɪ k w ɛ n t	f r ɪ k w ɛ n t ə d
f r ɔ s t	f r ɔ s t ə d
f r ʌ n t	f r ʌ n t ə d
f r ʌ s t r eɪ t	f r ʌ s t r eɪ t ə d
f ʊ t	f ʊ t ə d
f ʌ l m ɪ n eɪ t	f ʌ l m ɪ n eɪ t ə d
f ʌ n d	f ʌ n d ə d
ɡ a r d	ɡ a r d ə d
ɡ a r l ə n d	ɡ a r l ə n d ə d
ɡ aɪ d	ɡ aɪ d ə d
ɡ ɚ d	ɡ ɚ d ə d
ɡ ɪ l d	ɡ ɪ l d ə d
ɡ l aɪ d	ɡ l aɪ d ə d
ɡ l ɪ n t	ɡ l ɪ n t ə d
ɡ l oʊ t	ɡ l oʊ t ə d
ɡ l ʌ t	ɡ l ʌ t ə d
ɡ oʊ d	ɡ oʊ d ə d
ɡ oʊ s t	ɡ oʊ s t ə d
ɡ r æ ʤ u eɪ t	ɡ r æ ʤ u eɪ t ə d
ɡ r æ f t	ɡ r æ f t ə d
ɡ r æ n j ʊ l eɪ t	ɡ r æ n j ʊ l eɪ t ə d
ɡ r æ n t	ɡ r æ n t ə d
ɡ r aʊ n d	ɡ r aʊ n d ə d
ɡ r eɪ d	ɡ r eɪ d ə d
ɡ r eɪ t	ɡ r eɪ t ə d
ɡ r i t	ɡ r i t ə d
ɡ r ɪ t	ɡ r ɪ t ə d
ɡ r ʌ n t	ɡ r ʌ n t ə d
ɡ ʌ t	ɡ ʌ t ə d
h a r v ɪ s t	h a r v ɪ s t ə d
h æ n d	h æ n d ə d
h æ z ɚ d	h æ z ɚ d ə d
h aɪ b ɚ n eɪ t	h aɪ b ɚ n eɪ t ə d
h aɪ l aɪ t	h aɪ l aɪ t ə d
h aʊ n d	h aʊ n d ə d
h eɪ r ə l d	h eɪ r ə l d ə d
h eɪ t	h eɪ t ə d
h ə l u s ɪ n eɪ t	h ə l u s ɪ n eɪ t ə d
h ɛ d	h ɛ d ə d
h ɛ z ə t eɪ t	h ɛ z ə t eɪ t ə d
h ɚ d	h ɚ d ə d
h i d	h i d ə d
h i t	h i t ə d
h ɪ n t	h ɪ n t ə d
h j u m ɪ l i eɪ t	h j u m ɪ l i eɪ t ə d
h oʊ r d	h oʊ r d ə d
h oʊ s t	h oʊ s t ə d
h ɔ l t	h ɔ l t ə d
h ɔ n t	h ɔ n t ə d
h ɔɪ s t	h ɔɪ s t ə d
h u t	h u t ə d
h ʊ d	h ʊ d ə d
h ʌ n t	h ʌ n t ə d
h ʌ z b ə n d	h ʌ z b ə n d ə d
i l ɪ s ɪ t	i l ɪ s ɪ t ə d
i l ɔ ŋ ɡ eɪ t	i l ɔ ŋ ɡ eɪ t ə d
i m ɪ t	i m ɪ t ə d
i r ɛ k t	i r ɛ k t ə d
i r ɪ ɡ eɪ t	i r ɪ ɡ eɪ t ə d
i r ɪ t eɪ t	i r ɪ t eɪ t ə d
i r oʊ d	i r oʊ d ə d
i r ʌ p t	i r ʌ p t ə d
ɪ ʤ ɛ k t	ɪ ʤ ɛ k t ə d
ɪ f ɛ k t	ɪ f ɛ k t ə d
ɪ ɡ n aɪ t	ɪ ɡ n aɪ t ə d
ɪ ɡ z a n ə r eɪ t	ɪ ɡ z a n ə r eɪ t ə d
ɪ ɡ z æ ʤ ə r eɪ t	ɪ ɡ z æ ʤ ə r eɪ t ə d
ɪ ɡ z æ k t	ɪ ɡ z æ k t ə d
ɪ ɡ z æ s ɚ b eɪ t	ɪ ɡ z æ s ɚ b eɪ t ə d
ɪ ɡ z æ s p ə r eɪ t	ɪ ɡ z æ s p ə r eɪ t ə d
ɪ ɡ z ɛ m p t	ɪ ɡ z ɛ m p t ə d
ɪ ɡ z ɚ t	ɪ ɡ z ɚ t ə d
ɪ ɡ z ɪ b ɪ t	ɪ ɡ z ɪ b ɪ t ə d
ɪ ɡ z ɪ l ə r eɪ t	ɪ ɡ z ɪ l ə r eɪ t ə d
ɪ ɡ z ɪ s t	ɪ ɡ z ɪ s t ə d
ɪ ɡ z oʊ r t	ɪ ɡ z oʊ r t ə d
ɪ ɡ z ɔ l t	ɪ ɡ z ɔ l t ə d
ɪ ɡ z ɔ s t	ɪ ɡ z ɔ s t ə d
ɪ ɡ z u d	ɪ ɡ z u d ə d
ɪ ɡ z ʌ l t	ɪ ɡ z ʌ l t ə d
ɪ k s aɪ t	ɪ k s aɪ t ə d
ɪ k s i d	ɪ k s i d ə d
ɪ k s k l u d	ɪ k s k l u d ə d
ɪ k s k r i t	ɪ k s k r i t ə d
ɪ k s p a s ʧ ʊ l eɪ t	ɪ k s p a s ʧ ʊ l eɪ t ə d
ɪ k s p æ n d	ɪ k s p æ n d ə d
ɪ k s p aʊ n d	ɪ k s p aʊ n d ə d
ɪ k s p eɪ r ɪ m ə n t	ɪ k s p eɪ r ɪ m ə n t ə d
ɪ k s p ɛ k t	ɪ k s p ɛ k t ə d
ɪ k s p ɛ n d	ɪ k s p ɛ n d ə d
ɪ k s p l oʊ d	ɪ k s p l oʊ d ə d
ɪ k s p l ɔɪ t	ɪ k s p l ɔɪ t ə d
ɪ k s p oʊ r t	ɪ k s p oʊ r t ə d
ɪ k s t ɛ n d	ɪ k s t ɛ n d ə d
ɪ k s t ɚ m ɪ n eɪ t	ɪ k s t ɚ m ɪ n eɪ t ə d
ɪ k s t r æ k t	ɪ k s t r æ k t ə d
ɪ k s t r æ p ə l eɪ t	ɪ k s t r æ p ə l eɪ t ə d
ɪ k s t r u d	ɪ k s t r u d ə d
ɪ k w eɪ t	ɪ k w eɪ t ə d
ɪ k w ɪ v ə k eɪ t	ɪ k w ɪ v ə k eɪ t ə d
ɪ l æ b ə r eɪ t	ɪ l æ b ə r eɪ t ə d
ɪ l ə s t r eɪ t	ɪ l ə s t r eɪ t ə d
ɪ l ɛ k t	ɪ l ɛ k t ə d
ɪ l ɛ k t r ə k j u t	ɪ l ɛ k t r ə k j u t ə d
ɪ l ɪ m ə n eɪ t	ɪ l ɪ m ə n eɪ t ə d
ɪ l t r i t	ɪ l t r i t ə d
ɪ l u d	ɪ l u d ə d
ɪ l u m ɪ n eɪ t	ɪ l u m ɪ n eɪ t ə d
ɪ l u s ɪ d eɪ t	ɪ l u s ɪ d eɪ t ə d
ɪ m æ n s ɪ p eɪ t	ɪ m æ n s ɪ p eɪ t ə d
ɪ m b ɛ d	ɪ m b ɛ d ə d
ɪ m eɪ ʃ i eɪ t	ɪ m eɪ ʃ i eɪ t ə d
ɪ m ə t eɪ t	ɪ m ə t eɪ t ə d
ɪ m p a r t	ɪ m p a r t ə d
ɪ m p æ k t	ɪ m p æ k t ə d
ɪ m p aʊ n d	ɪ m p aʊ n d ə d
ɪ m p ɚ s ə n eɪ t	ɪ m p ɚ s ə n eɪ t ə d
ɪ m p i d	ɪ m p i d ə d
ɪ m p l æ n t	ɪ m p l æ n t ə d
ɪ m p l ə m ɛ n t	ɪ m p l ə m ɛ n t ə d
ɪ m p l ɪ k eɪ t	ɪ m p l ɪ k eɪ t ə d
ɪ m p oʊ r t	ɪ m p oʊ r t ə d
ɪ m p r ɛ ɡ n eɪ t	ɪ m p r ɛ ɡ n eɪ t ə d
ɪ m p r ɪ n t	ɪ m p r ɪ n t ə d
ɪ n a k j ʊ l eɪ t	ɪ n a k j ʊ l eɪ t ə d
ɪ n æ k t	ɪ n æ k t ə d
ɪ n d a k t r ɪ n eɪ t	ɪ n d a k t r ɪ n eɪ t ə d
ɪ n d aɪ t	ɪ n d aɪ t ə d
ɪ n d ə k eɪ t	ɪ n d ə k eɪ t ə d
ɪ n ʤ ɛ k t	ɪ n ʤ ɛ k t ə d
ɪ n ʤ ɛ s t	ɪ n ʤ ɛ s t ə d
ɪ n f ɛ k t	ɪ n f ɛ k t ə d
ɪ n f ɛ s t	ɪ n f ɛ s t ə d
ɪ n f ɪ l t r eɪ t	ɪ n f ɪ l t r eɪ t ə d
ɪ n f j u r i eɪ t	ɪ n f j u r i eɪ t ə d
ɪ n f l eɪ t	ɪ n f l eɪ t ə d
ɪ n f oʊ l d	ɪ n f oʊ l d ə d
ɪ n ɡ r eɪ ʃ i eɪ t	ɪ n ɡ r eɪ ʃ i eɪ t ə d
ɪ n h æ b ɪ t	ɪ n h æ b ɪ t ə d
ɪ n h eɪ r ɪ t	ɪ n h eɪ r ɪ t ə d
ɪ n h ɪ b ɪ t	ɪ n h ɪ b ɪ t ə d
ɪ n ɪ ʃ i eɪ t	ɪ n ɪ ʃ i eɪ t ə d
ɪ n k a r s ɚ eɪ t	ɪ n k a r s ɚ eɪ t ə d
ɪ n k æ p s ʊ l eɪ t	ɪ n k æ p s ʊ l eɪ t ə d
ɪ n k ə p æ s ɪ t eɪ t	ɪ n k ə p æ s ɪ t eɪ t ə d
ɪ n k l u d	ɪ n k l u d ə d
ɪ n k oʊ r p ɚ eɪ t	ɪ n k oʊ r p ɚ eɪ t ə d
ɪ n k r ɪ m ɪ n eɪ t	ɪ n k r ɪ m ɪ n eɪ t ə d
ɪ n k r ʌ s t	ɪ n k r ʌ s t ə d
ɪ n k ʌ l k eɪ t	ɪ n k ʌ l k eɪ t ə d
ɪ n l ɪ s t	ɪ n l ɪ s t ə d
ɪ n oʊ v eɪ t	ɪ n oʊ v eɪ t ə d
ɪ n ɔ ɡ j ʊ r eɪ t	ɪ n ɔ ɡ j ʊ r eɪ t ə d
ɪ n s aɪ t	ɪ n s aɪ t ə d
ɪ n s ə l eɪ t	ɪ n s ə l eɪ t ə d
ɪ n s ɚ t	ɪ n s ɚ t ə d
ɪ n s ɪ n ə r eɪ t	ɪ n s ɪ n ə r eɪ t ə d
ɪ n s ɪ n j u eɪ t	ɪ n s ɪ n j u eɪ t ə d
ɪ n s ɪ s t	ɪ n s ɪ s t ə d
ɪ n s p ɛ k t	ɪ n s p ɛ k t ə d
ɪ n s t ə t u t	ɪ n s t ə t u t ə d
ɪ n s t ɪ ɡ eɪ t	ɪ n s t ɪ ɡ eɪ t ə d
ɪ n s t r ʌ k t	ɪ n s t r ʌ k t ə d
ɪ n s ʌ l t	ɪ n s ʌ l t ə d
ɪ n t a k s ɪ k eɪ t	ɪ n t a k s ɪ k eɪ t ə d
ɪ n t eɪ r ə ɡ eɪ t	ɪ n t eɪ r ə ɡ eɪ t ə d
ɪ n t ə ɡ r eɪ t	ɪ n t ə ɡ r eɪ t ə d
ɪ n t ə m eɪ t	ɪ n t ə m eɪ t ə d
ɪ n t ə r æ k t	ɪ n t ə r æ k t ə d
ɪ n t ə r ɪ l eɪ t	ɪ n t ə r ɪ l eɪ t ə d
ɪ n t ə r ʌ p t	ɪ n t ə r ʌ p t ə d
ɪ n t ɛ n d	ɪ n t ɛ n d ə d
ɪ n t ɚ ʤ ɛ k t	ɪ n t ɚ ʤ ɛ k t ə d
ɪ n t ɚ p r ɪ t	ɪ n t ɚ p r ɪ t ə d
ɪ n t ɚ s ɛ k t	ɪ n t ɚ s ɛ k t ə d
ɪ n t ɚ s ɛ p t	ɪ n t ɚ s ɛ p t ə d
ɪ n t ɚ s i d	ɪ n t ɚ s i d ə d
ɪ n t ɪ m ɪ d eɪ t	ɪ n t ɪ m ɪ d eɪ t ə d
ɪ n t r ə s t	ɪ n t r ə s t ə d
ɪ n t r i t	ɪ n t r i t ə d
ɪ n t r u d	ɪ n t r u d ə d
ɪ n t r ʌ s t	ɪ n t r ʌ s t ə d
ɪ n t u ɪ t	ɪ n t u ɪ t ə d
ɪ n ʧ æ n t	ɪ n ʧ æ n t ə d
ɪ n u m ə r eɪ t	ɪ n u m ə r eɪ t ə d
ɪ n v æ l ɪ d eɪ t	ɪ n v æ l ɪ d eɪ t ə d
ɪ n v aɪ t	ɪ n v aɪ t ə d
ɪ n v eɪ d	ɪ n v eɪ d ə d
ɪ n v ɛ n t	ɪ n v ɛ n t ə d
ɪ n v ɛ s t	ɪ n v ɛ s t ə d
ɪ n v ɛ s t ə ɡ eɪ t	ɪ n v ɛ s t ə ɡ eɪ t ə d
ɪ n v ɚ t	ɪ n v ɚ t ə d
ɪ n v ɪ ɡ ə r eɪ t	ɪ n v ɪ ɡ ə r eɪ t ə d
ɪ n ʌ n d eɪ t	ɪ n ʌ n d eɪ t ə d
ɪ n ʌ n s i eɪ t	ɪ n ʌ n s i eɪ t ə d
ɪ r æ d ə k eɪ t	ɪ r æ d ə k eɪ t ə d
ɪ s k oʊ r t	ɪ s k oʊ r t ə d
ɪ v æ k j u eɪ t	ɪ v æ k j u eɪ t ə d
ɪ v æ l j u eɪ t	ɪ v æ l j u eɪ t ə d
ɪ v æ p ə r eɪ t	ɪ v æ p ə r eɪ t ə d
ɪ v eɪ d	ɪ v eɪ d ə d
ɪ v ɪ k t	ɪ v ɪ k t ə d
j i l d	j i l d ə d
j u n aɪ t	j u n aɪ t ə d
j u r ɪ n eɪ t	j u r ɪ n eɪ t ə d
k a m b æ t	k a m b æ t ə d
k a m ɛ n t	k a m ɛ n t ə d
k a m p ɛ n s eɪ t	k a m p ɛ n s eɪ t ə d
k a m p l ə k eɪ t	k a m p l ə k eɪ t ə d
k a m p l ɪ m ɛ n t	k a m p l ɪ m ɛ n t ə d
k a m p l ɪ m ɛ n t	k a m p l ɪ m ɛ n t ə d
k a m p oʊ s t	k a m p oʊ s t ə d
k a m p r ɪ h ɛ n d	k a m p r ɪ h ɛ n d ə d
k a n d ɪ s ɛ n d	k a n d ɪ s ɛ n d ə d
k a n f ɪ s k eɪ t	k a n f ɪ s k eɪ t ə d
k a n s ə m eɪ t	k a n s ə m eɪ t ə d
k a n s ə n t r eɪ t	k a n s ə n t r eɪ t ə d
k a n s ɪ k r eɪ t	k a n s ɪ k r eɪ t ə d
k a n s t ə t u t	k a n s t ə t u t ə d
k a n t æ k t	k a n t æ k t ə d
k a n t ə m p l eɪ t	k a n t ə m p l eɪ t ə d
k a n t r ə d ɪ k t	k a n t r ə d ɪ k t ə d
k a ŋ ɡ r ə ɡ eɪ t	k a ŋ ɡ r ə ɡ eɪ t ə d
k a p j ʊ l eɪ t	k a p j ʊ l eɪ t ə d
k a r p ɪ t	k a r p ɪ t ə d
k a r t	k a r t ə d
k a s ɪ t	k a s ɪ t ə d
k æ l k j ʊ l eɪ t	k æ l k j ʊ l eɪ t ə d
k æ n t	k æ n t ə d
k æ p t ɪ v eɪ t	k æ p t ɪ v eɪ t ə d
k æ s k eɪ d	k æ s k eɪ d ə d
k æ s t ɪ ɡ eɪ t	k æ s t ɪ ɡ eɪ t ə d
k æ s t r eɪ t	k æ s t r eɪ t ə d
k aʊ n t	k aʊ n t ə d
k aʊ n t ə r æ k t	k aʊ n t ə r æ k t ə d
k aʊ n t ɚ f ɪ t	k aʊ n t ɚ f ɪ t ə d
k ə l æ b ə r eɪ t	k ə l æ b ə r eɪ t ə d
k ə l aɪ d	k ə l aɪ d ə d
k ə l eɪ t	k ə l eɪ t ə d
k ə l ɛ k t	k ə l ɛ k t ə d
k ə l u d	k ə l u d ə d
k ə m æ n d	k ə m æ n d ə d
k ə m ɛ m ə r eɪ t	k ə m ɛ m ə r eɪ t ə d
k ə m ɛ n d	k ə m ɛ n d ə d
k ə m ɪ t	k ə m ɪ t ə d
k ə m j u n ɪ k eɪ t	k ə m j u n ɪ k eɪ t ə d
k ə m j u t	k ə m j u t ə d
k ə m p aʊ n d	k ə m p aʊ n d ə d
k ə m p i t	k ə m p i t ə d
k ə m p j u t	k ə m p j u t ə d
k ə m p l i t	k ə m p l i t ə d
k ə n d ʌ k t	k ə n d ʌ k t ə d
k ə n ɛ k t	k ə n ɛ k t ə d
k ə n f aɪ d	k ə n f aɪ d ə d
k ə n f aʊ n d	k ə n f aʊ n d ə d
k ə n f l ɪ k t	k ə n f l ɪ k t ə d
k ə n f r ʌ n t	k ə n f r ʌ n t ə d
k ə n ɡ r æ ʧ ʊ l eɪ t	k ə n ɡ r æ ʧ ʊ l eɪ t ə d
k ə n k a k t	k ə n k a k t ə d
k ə n k l u d	k ə n k l u d ə d
k ə n oʊ t	k ə n oʊ t ə d
k ə n s a l ɪ d eɪ t	k ə n s a l ɪ d eɪ t ə d
k ə n s ɛ n t	k ə n s ɛ n t ə d
k ə n s i d	k ə n s i d ə d
k ə n s k r ɪ p t	k ə n s k r ɪ p t ə d
k ə n s t r ɪ k t	k ə n s t r ɪ k t ə d
k ə n s t r ʌ k t	k ə n s t r ʌ k t ə d
k ə n s ʌ l t	k ə n s ʌ l t ə d
k ə n t æ m ɪ n eɪ t	k ə n t æ m ɪ n eɪ t ə d
k ə n t ɛ n d	k ə n t ɛ n d ə d
k ə n t ɛ n t	k ə n t ɛ n t ə d
k ə n t ɛ s t	k ə n t ɛ s t ə d
k ə n t oʊ r t	k ə n t oʊ r t ə d
k ə n t r æ k t	k ə n t r æ k t ə d
k ə n t r æ s t	k ə n t r æ s t ə d
k ə n t r ɪ b j u t	k ə n t r ɪ b j u t ə d
k ə n v ɚ t	k ə n v ɚ t ə d
k ə n v ɪ k t	k ə n v ɪ k t ə d
k ə p ɪ ʧ ʊ l eɪ t	k ə p ɪ ʧ ʊ l eɪ t ə d
k ə r a b ə r eɪ t	k ə r a b ə r eɪ t ə d
k ə r ɛ k t	k ə r ɛ k t ə d
k ə r oʊ d	k ə r oʊ d ə d
k ə r ʌ p t	k ə r ʌ p t ə d
k ə v oʊ r t	k ə v oʊ r t ə d
k ɪ d	k ɪ d ə d
k l a t	k l a t ə d
k l a z ɪ t	k l a z ɪ t ə d
k l aʊ d	k l aʊ d ə d
k l aʊ t	k l aʊ t ə d
k oʊ a p ə r eɪ t	k oʊ a p ə r eɪ t ə d
k oʊ a p t	k oʊ a p t ə d
k oʊ æ ɡ j ʊ l eɪ t	k oʊ æ ɡ j ʊ l eɪ t ə d
k oʊ d	k oʊ d ə d
k oʊ ɪ ɡ z ɪ s t	k oʊ ɪ ɡ z ɪ s t ə d
k oʊ ɪ n s aɪ d	k oʊ ɪ n s aɪ d ə d
k oʊ r d	k oʊ r d ə d
k oʊ r ə ɡ eɪ t	k oʊ r ə ɡ eɪ t ə d
k oʊ r ə l eɪ t	k oʊ r ə l eɪ t ə d
k oʊ r ɪ s p a n d	k oʊ r ɪ s p a n d ə d
k oʊ r t	k oʊ r t ə d
k oʊ s t	k oʊ s t ə d
k oʊ t	k oʊ t ə d
k oʊ w oʊ r d ɪ n eɪ t	k oʊ w oʊ r d ɪ n eɪ t ə d
k r æ f t	k r æ f t ə d
k r aʊ d	k r aʊ d ə d
k r eɪ t	k r eɪ t ə d
k r ɛ d ɪ t	k r ɛ d ɪ t ə d
k r i eɪ t	k r i eɪ t ə d
k r i m eɪ t	k r i m eɪ t ə d
k r u s eɪ d	k r u s eɪ d ə d
k ʌ l t ɪ v eɪ t	k ʌ l t ɪ v eɪ t ə d
k ʌ m f ɚ t	k ʌ m f ɚ t ə d
k ʌ v ɪ t	k ʌ v ɪ t ə d
k w aɪ ə t	k w aɪ ə t ə d
k w ɛ s t	k w ɛ s t ə d
k w oʊ t	k w oʊ t ə d
l æ m ɪ n eɪ t	l æ m ɪ n eɪ t ə d
l æ n d	l æ n d ə d
l æ s ə r eɪ t	l æ s ə r eɪ t ə d
l æ s t	l æ s t ə d
l ə m ɛ n t	l ə m ɛ n t ə d
l ɛ ʤ ɪ s l eɪ t	l ɛ ʤ ɪ s l eɪ t ə d
l ɪ b ə r eɪ t	l ɪ b ə r eɪ t ə d
l ɪ f t	l ɪ f t ə d
l ɪ k w ɪ d eɪ t	l ɪ k w ɪ d eɪ t ə d
l ɪ l t	l ɪ l t ə d
l ɪ m ɪ t	l ɪ m ɪ t ə d
l ɪ s t	l ɪ s t ə d
l oʊ d	l oʊ d ə d
l oʊ k eɪ t	l oʊ k eɪ t ə d
l oʊ r d	l oʊ r d ə d
l ɔ d	l ɔ d ə d
l u b r ɪ k eɪ t	l u b r ɪ k eɪ t ə d
l u t	l u t ə d
m a d ə r eɪ t	m a d ə r eɪ t ə d
m a ʤ u l eɪ t	m a ʤ u l eɪ t ə d
m a r k ɪ t	m a r k ɪ t ə d
m æ l t r i t	m æ l t r i t ə d
m æ n ɪ f ɛ s t	m æ n ɪ f ɛ s t ə d
m æ s k ə r eɪ d	m æ s k ə r eɪ d ə d
m æ s t ɚ b eɪ t	m æ s t ɚ b eɪ t ə d
m æ s t ɚ m aɪ n d	m æ s t ɚ m aɪ n d ə d
m æ t	m æ t ə d
m aɪ ɡ r eɪ t	m aɪ ɡ r eɪ t ə d
m aɪ n d	m aɪ n d ə d
m aʊ n t	m aʊ n t ə d
m eɪ r ɪ n eɪ t	m eɪ r ɪ n eɪ t ə d
m eɪ r ɪ t	m eɪ r ɪ t ə d
m eɪ t	m eɪ t ə d
m ə l ɛ s t	m ə l ɛ s t ə d
m ə n ɪ p j ʊ l eɪ t	m ə n ɪ p j ʊ l eɪ t ə d
m ə r ɔ d	m ə r ɔ d ə d
m ɛ d ɪ t eɪ t	m ɛ d ɪ t eɪ t ə d
m ɛ l t	m ɛ l t ə d
m ɛ n d	m ɛ n d ə d
m ɛ n s t r u eɪ t	m ɛ n s t r u eɪ t ə d
m ɛ θ ə l eɪ t	m ɛ θ ə l eɪ t ə d
m i d i eɪ t	m i d i eɪ t ə d
m ɪ n t	m ɪ n t ə d
m ɪ s d i r ɛ k t	m ɪ s d i r ɛ k t ə d
m ɪ s ɪ n t ɚ p r ɪ t	m ɪ s ɪ n t ɚ p r ɪ t ə d
m ɪ s r ɛ p r ɪ z ɛ n t	m ɪ s r ɛ p r ɪ z ɛ n t ə d
m ɪ s t	m ɪ s t ə d
m ɪ s t r ʌ s t	m ɪ s t r ʌ s t ə d
m ɪ t ɪ ɡ eɪ t	m ɪ t ɪ ɡ eɪ t ə d
m j u t	m j u t ə d
m j u t eɪ t	m j u t eɪ t ə d
m j u t ɪ l eɪ t	m j u t ɪ l eɪ t ə d
m oʊ l d	m oʊ l d ə d
m oʊ l t	m oʊ l t ə d
m oʊ t ɪ v eɪ t	m oʊ t ɪ v eɪ t ə d
m ɔ l t	m ɔ l t ə d
m u t	m u t ə d
n a d	n a d ə d
n a m ɪ n eɪ t	n a m ɪ n eɪ t ə d
n a t	n a t ə d
n æ v ɪ ɡ eɪ t	n æ v ɪ ɡ eɪ t ə d
n aɪ t	n aɪ t ə d
n eɪ r eɪ t	n eɪ r eɪ t ə d
n ə s ɛ s ɪ t eɪ t	n ə s ɛ s ɪ t eɪ t ə d
n ɛ s t	n ɛ s t ə d
n i d	n i d ə d
n i d	n i d ə d
n ɪ ɡ eɪ t	n ɪ ɡ eɪ t ə d
n ɪ ɡ l ɛ k t	n ɪ ɡ l ɛ k t ə d
n ɪ ɡ oʊ ʃ i eɪ t	n ɪ ɡ oʊ ʃ i eɪ t ə d
n oʊ t	n oʊ t ə d
n ɔ z i eɪ t	n ɔ z i eɪ t ə d
oʊ m ɪ t	oʊ m ɪ t ə d
oʊ r b ɪ t	oʊ r b ɪ t ə d
oʊ r eɪ t	oʊ r eɪ t ə d
oʊ r i ə n t	oʊ r i ə n t ə d
oʊ r i ɛ n t eɪ t	oʊ r i ɛ n t eɪ t ə d
oʊ r k ɪ s t r eɪ t	oʊ r k ɪ s t r eɪ t ə d
oʊ r n ə m ɛ n t	oʊ r n ə m ɛ n t ə d
oʊ v ɚ ɛ s t ɪ m eɪ t	oʊ v ɚ ɛ s t ɪ m eɪ t ə d
oʊ v ɚ k r aʊ d	oʊ v ɚ k r aʊ d ə d
oʊ v ɚ l oʊ d	oʊ v ɚ l oʊ d ə d
oʊ v ɚ r eɪ t	oʊ v ɚ r eɪ t ə d
oʊ v ɚ s t eɪ t	oʊ v ɚ s t eɪ t ə d
ɔ d ɪ t	ɔ d ɪ t ə d
ɔ ɡ m ɛ n t	ɔ ɡ m ɛ n t ə d
ɔ l t ɚ n eɪ t	ɔ l t ɚ n eɪ t ə d
ɔ t oʊ m eɪ t	ɔ t oʊ m eɪ t ə d
ɔ θ ɛ n t ɪ k eɪ t	ɔ θ ɛ n t ɪ k eɪ t ə d
p a k ɪ t	p a k ɪ t ə d
p a p j ʊ l eɪ t	p a p j ʊ l eɪ t ə d
p a r t	p a r t ə d
p a r t ɪ s ɪ p eɪ t	p a r t ɪ s ɪ p eɪ t ə d
p a s ʧ ə l eɪ t	p a s ʧ ə l eɪ t ə d
p a t	p a t ə d
p a z ɪ t	p a z ɪ t ə d
p æ d	p æ d ə d
p æ l p ɪ t eɪ t	p æ l p ɪ t eɪ t ə d
p æ n t	p æ n t ə d
p æ t	p æ t ə d
p æ t ə n t	p æ t ə n t ə d
p aɪ l ə t	p aɪ l ə t ə d
p aʊ n d	p aʊ n d ə d
p aʊ t	p aʊ t ə d
p eɪ n t	p eɪ n t ə d
p eɪ s t	p eɪ s t ə d
p ə l u t	p ə l u t ə d
p ə r eɪ d	p ə r eɪ d ə d
p ɛ l t	p ɛ l t ə d
p ɛ n ə t r eɪ t	p ɛ n ə t r eɪ t ə d
p ɛ t	p ɛ t ə d
p ɚ f ə r eɪ t	p ɚ f ə r eɪ t ə d
p ɚ f ɛ k t	p ɚ f ɛ k t ə d
p ɚ k ə l eɪ t	p ɚ k ə l eɪ t ə d
p ɚ m i eɪ t	p ɚ m i eɪ t ə d
p ɚ m ɪ t	p ɚ m ɪ t ə d
p ɚ p ɛ ʧ u eɪ t	p ɚ p ɛ ʧ u eɪ t ə d
p ɚ p ɪ t r eɪ t	p ɚ p ɪ t r eɪ t ə d
p ɚ p oʊ r t	p ɚ p oʊ r t ə d
p ɚ s ɪ k j u t	p ɚ s ɪ k j u t ə d
p ɚ s ɪ s t	p ɚ s ɪ s t ə d
p ɚ s w eɪ d	p ɚ s w eɪ d ə d
p ɚ v eɪ d	p ɚ v eɪ d ə d
p ɚ v ɚ t	p ɚ v ɚ t ə d
p ɪ k ɪ t	p ɪ k ɪ t ə d
p ɪ n p ɔɪ n t	p ɪ n p ɔɪ n t ə d
p ɪ t	p ɪ t ə d
p ɪ v ə t	p ɪ v ə t ə d
p l a d	p l a d ə d
p l a t	p l a t ə d
p l æ n t	p l æ n t ə d
p l eɪ æ k t	p l eɪ æ k t ə d
p l eɪ k eɪ t	p l eɪ k eɪ t ə d
p l eɪ t	p l eɪ t ə d
p l eɪ t	p l eɪ t ə d
p l i d	p l i d ə d
p l i t	p l i t ə d
p l ʌ m ɪ t	p l ʌ m ɪ t ə d
p oʊ r t ɛ n d	p oʊ r t ɛ n d ə d
p oʊ s t	p oʊ s t ə d
p ɔɪ n t	p ɔɪ n t ə d
p r a d	p r a d ə d
p r a f ɪ t	p r a f ɪ t ə d
p r a m ə l ɡ eɪ t	p r a m ə l ɡ eɪ t ə d
p r a m p t	p r a m p t ə d
p r a p ə ɡ eɪ t	p r a p ə ɡ eɪ t ə d
p r a s ə k j u t	p r a s ə k j u t ə d
p r a s p ɛ k t	p r a s p ɛ k t ə d
p r ə ʤ ɛ k t	p r ə ʤ ɛ k t ə d
p r ə m oʊ t	p r ə m oʊ t ə d
p r ə p aʊ n d	p r ə p aʊ n d ə d
p r ə s i d	p r ə s i d ə d
p r ə s ɪ p ɪ t eɪ t	p r ə s ɪ p ɪ t eɪ t ə d
p r ə t ɛ k t	p r ə t ɛ k t ə d
p r ə t ɛ s t	p r ə t ɛ s t ə d
p r ə t r u d	p r ə t r u d ə d
p r ə v aɪ d	p r ə v aɪ d ə d
p r ɛ d ɪ k eɪ t	p r ɛ d ɪ k eɪ t ə d
p r i ɛ m p t	p r i ɛ m p t ə d
p r i ɪ ɡ z ɪ s t	p r i ɪ ɡ z ɪ s t ə d
p r ɪ d a m ɪ n eɪ t	p r ɪ d a m ɪ n eɪ t ə d
p r ɪ d ɪ k t	p r ɪ d ɪ k t ə d
p r ɪ k l u d	p r ɪ k l u d ə d
p r ɪ n t	p r ɪ n t ə d
p r ɪ s i d	p r ɪ s i d ə d
p r ɪ t ɛ n d	p r ɪ t ɛ n d ə d
p r ɪ v eɪ r ɪ k eɪ t	p r ɪ v eɪ r ɪ k eɪ t ə d
p r ɪ v ɛ n t	p r ɪ v ɛ n t ə d
p r ɪ z aɪ d	p r ɪ z aɪ d ə d
p r ɪ z ɛ n t	p r ɪ z ɛ n t ə d
p r oʊ h ɪ b ə t	p r oʊ h ɪ b ə t ə d
p r oʊ l ɪ f ɚ eɪ t	p r oʊ l ɪ f ɚ eɪ t ə d
p r oʊ t r æ k t	p r oʊ t r æ k t ə d
p r ɔ s t ɪ t u t	p r ɔ s t ɪ t u t ə d
p r ɔ s t r eɪ t	p r ɔ s t r eɪ t ə d
p ʌ l s eɪ t	p ʌ l s eɪ t ə d
p ʌ ŋ k ʧ u eɪ t	p ʌ ŋ k ʧ u eɪ t ə d
p ʌ t	p ʌ t ə d
r a k ɪ t	r a k ɪ t ə d
r a t	r a t ə d
r æ n t	r æ n t ə d
r aɪ ə t	r aɪ ə t ə d
r aɪ t	r aɪ t ə d
r aʊ n d	r aʊ n d ə d
r aʊ t	r aʊ t ə d
r eɪ d	r eɪ d ə d
r eɪ d i eɪ t	r eɪ d i eɪ t ə d
r eɪ t	r eɪ t ə d
r ɛ ʤ ɪ m ɛ n t	r ɛ ʤ ɪ m ɛ n t ə d
r ɛ ɡ j ʊ l eɪ t	r ɛ ɡ j ʊ l eɪ t ə d
r ɛ k ə l ɛ k t	r ɛ k ə l ɛ k t ə d
r ɛ k ə m ɛ n d	r ɛ k ə m ɛ n d ə d
r ɛ l ɪ ɡ eɪ t	r ɛ l ɪ ɡ eɪ t ə d
r ɛ n oʊ v eɪ t	r ɛ n oʊ v eɪ t ə d
r ɛ n t	r ɛ n t ə d
r ɛ p l ɪ k eɪ t	r ɛ p l ɪ k eɪ t ə d
r ɛ p r ɪ m æ n d	r ɛ p r ɪ m æ n d ə d
r ɛ p r ɪ z ɛ n t	r ɛ p r ɪ z ɛ n t ə d
r ɛ s t	r ɛ s t ə d
r ɛ s t	r ɛ s t ə d
r ɛ z ə n eɪ t	r ɛ z ə n eɪ t ə d
r ɛ z ə r ɛ k t	r ɛ z ə r ɛ k t ə d
r i æ k t	r i æ k t ə d
r i æ k t ɪ v eɪ t	r i æ k t ɪ v eɪ t ə d
r i b aʊ n d	r i b aʊ n d ə d
r i d ɛ k ə r eɪ t	r i d ɛ k ə r eɪ t ə d
r i d i r ɛ k t	r i d i r ɛ k t ə d
r i d ɪ s t r ɪ b j u t	r i d ɪ s t r ɪ b j u t ə d
r i ʤ ɛ n ɚ eɪ t	r i ʤ ɛ n ɚ eɪ t ə d
r i ə b ɪ l ɪ t eɪ t	r i ə b ɪ l ɪ t eɪ t ə d
r i ə ʤ ʌ s t	r i ə ʤ ʌ s t ə d
r i f ɪ t	r i f ɪ t ə d
r i f l eɪ t	r i f l eɪ t ə d
r i ɪ n s t eɪ t	r i ɪ n s t eɪ t ə d
r i ɪ t ə r eɪ t	r i ɪ t ə r eɪ t ə d
r i j u n aɪ t	r i j u n aɪ t ə d
r i k a n s t ɪ t u t	r i k a n s t ɪ t u t ə d
r i k æ s t	r i k æ s t ə d
r i k ə n s t r ʌ k t	r i k ə n s t r ʌ k t ə d
r i k ə p ɪ ʧ u l eɪ t	r i k ə p ɪ ʧ u l eɪ t ə d
r i k r i eɪ t	r i k r i eɪ t ə d
r i l oʊ d	r i l oʊ d ə d
r i l oʊ k eɪ t	r i l oʊ k eɪ t ə d
r i m aʊ n t	r i m aʊ n t ə d
r i p eɪ n t	r i p eɪ n t ə d
r i p eɪ t r i eɪ t	r i p eɪ t r i eɪ t ə d
r i p r ɪ n t	r i p r ɪ n t ə d
r i s t eɪ t	r i s t eɪ t ə d
r i v ɚ b ɚ eɪ t	r i v ɚ b ɚ eɪ t ə d
r ɪ ʤ ɛ k t	r ɪ ʤ ɛ k t ə d
r ɪ ʤ u v ə n eɪ t	r ɪ ʤ u v ə n eɪ t ə d
r ɪ f j u t	r ɪ f j u t ə d
r ɪ f l ɛ k t	r ɪ f l ɛ k t ə d
r ɪ f r æ k t	r ɪ f r æ k t ə d
r ɪ f r ɪ ʤ ə r eɪ t	r ɪ f r ɪ ʤ ə r eɪ t ə d
r ɪ ɡ a r d	r ɪ ɡ a r d ə d
r ɪ ɡ ɚ ʤ ɪ t eɪ t	r ɪ ɡ ɚ ʤ ɪ t eɪ t ə d
r ɪ ɡ r ɛ t	r ɪ ɡ r ɛ t ə d
r ɪ k æ n t	r ɪ k æ n t ə d
r ɪ k aʊ n t	r ɪ k aʊ n t ə d
r ɪ k oʊ r d	r ɪ k oʊ r d ə d
r ɪ k r u t	r ɪ k r u t ə d
r ɪ k u p ə r eɪ t	r ɪ k u p ə r eɪ t ə d
r ɪ k w ɛ s t	r ɪ k w ɛ s t ə d
r ɪ l eɪ t	r ɪ l eɪ t ə d
r ɪ l ɛ n t	r ɪ l ɛ n t ə d
r ɪ m æ n d	r ɪ m æ n d ə d
r ɪ m aɪ n d	r ɪ m aɪ n d ə d
r ɪ m ɪ t	r ɪ m ɪ t ə d
r ɪ p ɛ n t	r ɪ p ɛ n t ə d
r ɪ p i t	r ɪ p i t ə d
r ɪ p j u d i eɪ t	r ɪ p j u d i eɪ t ə d
r ɪ p oʊ r t	r ɪ p oʊ r t ə d
r ɪ s aɪ t	r ɪ s aɪ t ə d
r ɪ s i d	r ɪ s i d ə d
r ɪ s ɪ n d	r ɪ s ɪ n d ə d
r ɪ s ɪ p r ə k eɪ t	r ɪ s ɪ p r ə k eɪ t ə d
r ɪ s p a n d	r ɪ s p a n d ə d
r ɪ s p ɛ k t	r ɪ s p ɛ k t ə d
r ɪ s t r ɪ k t	r ɪ s t r ɪ k t ə d
r ɪ s ʌ s ɪ t eɪ t	r ɪ s ʌ s ɪ t eɪ t ə d
r ɪ t a r d	r ɪ t a r d ə d
r ɪ t æ l i eɪ t	r ɪ t æ l i eɪ t ə d
r ɪ t oʊ r t	r ɪ t oʊ r t ə d
r ɪ t r æ k t	r ɪ t r æ k t ə d
r ɪ t r i t	r ɪ t r i t ə d
r ɪ v ɪ t	r ɪ v ɪ t ə d
r ɪ v oʊ l t	r ɪ v oʊ l t ə d
r ɪ w oʊ r d	r ɪ w oʊ r d ə d
r ɪ z aɪ d	r ɪ z aɪ d ə d
r ɪ z aʊ n d	r ɪ z aʊ n d ə d
r ɪ z ɛ n t	r ɪ z ɛ n t ə d
r ɪ z ɪ s t	r ɪ z ɪ s t ə d
r ɪ z oʊ r t	r ɪ z oʊ r t ə d
r ɪ z ʌ l t	r ɪ z ʌ l t ə d
r oʊ s t	r oʊ s t ə d
r oʊ t eɪ t	r oʊ t eɪ t ə d
r u m ɪ n eɪ t	r u m ɪ n eɪ t ə d
r u s t	r u s t ə d
r u t	r u t ə d
r u t	r u t ə d
r ʌ s t	r ʌ s t ə d
r ʌ s t ɪ k eɪ t	r ʌ s t ɪ k eɪ t ə d
r ʌ t	r ʌ t ə d
s a d	s a d ə d
s æ n d	s æ n d ə d
s æ ʧ ɚ eɪ t	s æ ʧ ɚ eɪ t ə d
s aɪ d	s aɪ d ə d
s aɪ n p oʊ s t	s aɪ n p oʊ s t ə d
s aɪ t	s aɪ t ə d
s aɪ t	s aɪ t ə d
s aɪ t	s aɪ t ə d
s aʊ n d	s aʊ n d ə d
s eɪ f ɡ a r d	s eɪ f ɡ a r d ə d
s eɪ r ə n eɪ d	s eɪ r ə n eɪ d ə d
s eɪ ʃ i eɪ t	s eɪ ʃ i eɪ t ə d
s eɪ t	s eɪ t ə d
s ə b ʤ ɛ k t	s ə b ʤ ɛ k t ə d
s ə b m ɪ t	s ə b m ɪ t ə d
s ə b oʊ r d ɪ n eɪ t	s ə b oʊ r d ɪ n eɪ t ə d
s ə b s aɪ d	s ə b s aɪ d ə d
s ə b s ɪ s t	s ə b s ɪ s t ə d
s ə b s t æ n ʃ i eɪ t	s ə b s t æ n ʃ i eɪ t ə d
s ə b t r æ k t	s ə b t r æ k t ə d
s ə ɡ ʤ ɛ s t	s ə ɡ ʤ ɛ s t ə d
s ə k s i d	s ə k s i d ə d
s ə l ɛ k t	s ə l ɛ k t ə d
s ə l ɪ s ɪ t	s ə l ɪ s ɪ t ə d
s ə l u t	s ə l u t ə d
s ə p l æ n t	s ə p l æ n t ə d
s ə p oʊ r t	s ə p oʊ r t ə d
s ə r aʊ n d	s ə r aʊ n d ə d
s ə s p ɛ k t	s ə s p ɛ k t ə d
s ə s p ɛ n d	s ə s p ɛ n d ə d
s ɛ ɡ m ɛ n t	s ɛ ɡ m ɛ n t ə d
s ɛ ɡ r ɪ ɡ eɪ t	s ɛ ɡ r ɪ ɡ eɪ t ə d
s ɛ k ə n d	s ɛ k ə n d ə d
s ɛ l ə b r eɪ t	s ɛ l ə b r eɪ t ə d
s ɛ n t	s ɛ n t ə d
s ɛ p ə r eɪ t	s ɛ p ə r eɪ t ə d
s ɚ k ə m v ɛ n t	s ɚ k ə m v ɛ n t ə d
s ɚ k j ʊ l eɪ t	s ɚ k j ʊ l eɪ t ə d
s ɚ m aʊ n t	s ɚ m aʊ n t ə d
s i d	s i d ə d
s i d	s i d ə d
s i t	s i t ə d
s ɪ f t	s ɪ f t ə d
s ɪ k r i t	s ɪ k r i t ə d
s ɪ l u ɛ t	s ɪ l u ɛ t ə d
s ɪ m ɛ n t	s ɪ m ɛ n t ə d
s ɪ m j ʊ l eɪ t	s ɪ m j ʊ l eɪ t ə d
s ɪ n d ɪ k eɪ t	s ɪ n d ɪ k eɪ t ə d
s ɪ s i d	s ɪ s i d ə d
s ɪ ʧ u eɪ t	s ɪ ʧ u eɪ t ə d
s k aʊ t	s k aʊ t ə d
s k eɪ t	s k eɪ t ə d
s k ɚ t	s k ɚ t ə d
s k ɪ d	s k ɪ d ə d
s k oʊ l d	s k oʊ l d ə d
s k ɔ l d	s k ɔ l d ə d
s k u t	s k u t ə d
s k ʌ d	s k ʌ d ə d
s k ʌ l p t	s k ʌ l p t ə d
s k w a t	s k w a t ə d
s k w ɚ t	s k w ɚ t ə d
s k w ɪ n t	s k w ɪ n t ə d
s l a t	s l a t ə d
s l æ n t	s l æ n t ə d
s l aɪ t	s l aɪ t ə d
s l eɪ t	s l eɪ t ə d
s m a r t	s m a r t ə d
s m ɛ l t	s m ɛ l t ə d
s n oʊ r t	s n oʊ r t ə d
s oʊ r t	s oʊ r t ə d
s ɔ l t	s ɔ l t ə d
s p a t	s p a t ə d
s p aʊ t	s p aʊ t ə d
s p ɛ k j ʊ l eɪ t	s p ɛ k j ʊ l eɪ t ə d
s p ɚ t	s p ɚ t ə d
s p i r h ɛ d	s p i r h ɛ d ə d
s p i r ɪ t	s p i r ɪ t ə d
s p oʊ r t	s p oʊ r t ə d
s p r aʊ t	s p r aʊ t ə d
s p r ɪ n t	s p r ɪ n t ə d
s t a r t	s t a r t ə d
s t æ ɡ n eɪ t	s t æ ɡ n eɪ t ə d
s t æ m p i d	s t æ m p i d ə d
s t eɪ t	s t eɪ t ə d
s t ɪ m j ʊ l eɪ t	s t ɪ m j ʊ l eɪ t ə d
s t ɪ p j ʊ l eɪ t	s t ɪ p j ʊ l eɪ t ə d
s t r æ n d	s t r æ n d ə d
s t r ʌ t	s t r ʌ t ə d
s t ʌ d	s t ʌ d ə d
s t ʌ n t	s t ʌ n t ə d
s u p ɚ s i d	s u p ɚ s i d ə d
s u t	s u t ə d
s ʌ b d ɪ v aɪ d	s ʌ b d ɪ v aɪ d ə d
s ʌ b ʤ ə ɡ eɪ t	s ʌ b ʤ ə ɡ eɪ t ə d
s ʌ b l ɪ m eɪ t	s ʌ b l ɪ m eɪ t ə d
s ʌ b s t ɪ t u t	s ʌ b s t ɪ t u t ə d
s ʌ b v ɚ t	s ʌ b v ɚ t ə d
s ʌ f ə k eɪ t	s ʌ f ə k eɪ t ə d
s ʌ p j ɚ eɪ t	s ʌ p j ɚ eɪ t ə d
s ʌ p l ə m ɛ n t	s ʌ p l ə m ɛ n t ə d
s w a t	s w a t ə d
s w a t	s w a t ə d
s w ɛ t	s w ɛ t ə d
ʃ aʊ t	ʃ aʊ t ə d
ʃ eɪ d	ʃ eɪ d ə d
ʃ ɛ p ɚ d	ʃ ɛ p ɚ d ə d
ʃ i l d	ʃ i l d ə d
ʃ ɪ f t	ʃ ɪ f t ə d
ʃ ɪ t	ʃ ɪ t ə d
ʃ oʊ r t l ɪ s t	ʃ oʊ r t l ɪ s t ə d
ʃ oʊ r t s ɚ k ɪ t	ʃ oʊ r t s ɚ k ɪ t ə d
ʃ r aʊ d	ʃ r aʊ d ə d
ʃ r ɛ d	ʃ r ɛ d ə d
ʃ ʌ n t	ʃ ʌ n t ə d
t a l ə r eɪ t	t a l ə r eɪ t ə d
t aʊ t	t aʊ t ə d
t eɪ n t	t eɪ n t ə d
t eɪ s t	t eɪ s t ə d
t ɛ m p t	t ɛ m p t ə d
t ɛ n d	t ɛ n d ə d
t ɛ n ə n t	t ɛ n ə n t ə d
t ɛ s t	t ɛ s t ə d
t ɚ m ɪ n eɪ t	t ɚ m ɪ n eɪ t ə d
t ɪ l t	t ɪ l t ə d
t ɪ n t	t ɪ n t ə d
t ɪ t ɪ l eɪ t	t ɪ t ɪ l eɪ t ə d
t oʊ r m ɛ n t	t oʊ r m ɛ n t ə d
t oʊ s t	t oʊ s t ə d
t oʊ t	t oʊ t ə d
t ɔ n t	t ɔ n t ə d
t r a t	t r a t ə d
t r æ n s ɛ n d	t r æ n s ɛ n d ə d
t r æ n s l eɪ t	t r æ n s l eɪ t ə d
t r æ n s p l æ n t	t r æ n s p l æ n t ə d
t r æ n s p oʊ r t	t r æ n s p oʊ r t ə d
t r æ n z æ k t	t r æ n z æ k t ə d
t r æ n z m ɪ t	t r æ n z m ɪ t ə d
t r æ n z m j u t	t r æ n z m j u t ə d
t r eɪ d	t r eɪ d ə d
t r i t	t r i t ə d
t r ʌ m p ɪ t	t r ʌ m p ɪ t ə d
t r ʌ ŋ k eɪ t	t r ʌ ŋ k eɪ t ə d
t r ʌ s t	t r ʌ s t ə d
t u t	t u t ə d
t w ɪ s t	t w ɪ s t ə d
ʧ a r t	ʧ a r t ə d
ʧ æ n t	ʧ æ n t ə d
ʧ æ t	ʧ æ t ə d
ʧ aɪ d	ʧ aɪ d ə d
ʧ i t	ʧ i t ə d
v a m ɪ t	v a m ɪ t ə d
v æ l ɪ d eɪ t	v æ l ɪ d eɪ t ə d
v æ s ə l eɪ t	v æ s ə l eɪ t ə d
v aɪ b r eɪ t	v aɪ b r eɪ t ə d
v aɪ ə l eɪ t	v aɪ ə l eɪ t ə d
v eɪ k eɪ t	v eɪ k eɪ t ə d
v ɛ ʤ ɪ t eɪ t	v ɛ ʤ ɪ t eɪ t ə d
v ɛ n d	v ɛ n d ə d
v ɛ n ə r eɪ t	v ɛ n ə r eɪ t ə d
v ɛ n t	v ɛ n t ə d
v ɛ n t ɪ l eɪ t	v ɛ n t ɪ l eɪ t ə d
v ɛ s t	v ɛ s t ə d
v ɛ t	v ɛ t ə d
v ɪ n d ɪ k eɪ t	v ɪ n d ɪ k eɪ t ə d
v ɪ z ə t	v ɪ z ə t ə d
v oʊ t	v oʊ t ə d
v ɔ l t	v ɔ l t ə d
v ɔ n t	v ɔ n t ə d
ʌ n d ə r eɪ t	ʌ n d ə r eɪ t ə d
ʌ n d ɚ ɛ s t ə m eɪ t	ʌ n d ɚ ɛ s t ə m eɪ t ə d
ʌ n d ɚ s t eɪ t	ʌ n d ɚ s t eɪ t ə d
ʌ n ʤ u l eɪ t	ʌ n ʤ u l eɪ t ə d
ʌ n f oʊ l d	ʌ n f oʊ l d ə d
ʌ n l oʊ d	ʌ n l oʊ d ə d
ʌ n s i t	ʌ n s i t ə d
ʌ p b r eɪ d	ʌ p b r eɪ d ə d
ʌ p d eɪ t	ʌ p d eɪ t ə d
ʌ p ɛ n d	ʌ p ɛ n d ə d
ʌ p ɡ r eɪ d	ʌ p ɡ r eɪ d ə d
ʌ p l ɪ f t	ʌ p l ɪ f t ə d
ʌ p r u t	ʌ p r u t ə d
w a f t	w a f t ə d
w eɪ d	w eɪ d ə d
w eɪ s t	w eɪ s t ə d
w eɪ t	w eɪ t ə d
w eɪ t	w eɪ t ə d
w ɛ d	w ɛ d ə d
w ɛ l d	w ɛ l d ə d
w ɛ t	w ɛ t ə d
w ɚ d	w ɚ d ə d
w i d	w i d ə d
w i l d	w i l d ə d
w ɪ l t	w ɪ l t ə d
w oʊ r ə n t	w oʊ r ə n t ə d
w ɔ n t	w ɔ n t ə d
w u n d	w u n d ə d
θ r ɛ d	θ r ɛ d ə d
θ ʌ d	θ ʌ d ə d
θ w oʊ r t	θ w oʊ r t ə d














b ɛ t	b ɛ t
b ɚ s t	b ɚ s t
b i t	b i t
b ɪ d	b ɪ d
b ɪ s ɛ t	b ɪ s ɛ t
f ɪ t	f ɪ t
f oʊ r k æ s t	f oʊ r k æ s t
h ɚ t	h ɚ t
h ɪ t	h ɪ t
ɪ n s ɛ t	ɪ n s ɛ t
k æ s t	k æ s t
k ɔ s t	k ɔ s t
k ʌ t	k ʌ t
k w ɪ t	k w ɪ t
l ɛ t	l ɛ t
n ɪ t	n ɪ t
ɔ f s ɛ t	ɔ f s ɛ t
p ʊ t	p ʊ t
r i s ɛ t	r i s ɛ t
s ɛ t	s ɛ t
s l ɪ t	s l ɪ t
s p l ɪ t	s p l ɪ t
s p r ɛ d	s p r ɛ d
ʃ ɛ d	ʃ ɛ d
ʃ ʌ t	ʃ ʌ t
ʌ n d ɚ k ʌ t	ʌ n d ɚ k ʌ t
ʌ p s ɛ t	ʌ p s ɛ t
w ɛ t	w ɛ t
θ r ʌ s t	θ r ʌ s t








aʊ t ʃ aɪ n	aʊ t ʃ oʊ n
b eɪ r	b oʊ r
b ɪ s p i k	b ɪ s p oʊ k
b ɪ s t r aɪ d	b ɪ s t r oʊ d
b r eɪ k	b r oʊ k
d aɪ v	d oʊ v
d r aɪ v	d r oʊ v
ə r aɪ z	ə r oʊ z
ə w eɪ k	ə w oʊ k
f oʊ r b eɪ r	f oʊ r b oʊ r
f r i z	f r oʊ z
ɪ n t ɚ w i v	ɪ n t ɚ w oʊ v
oʊ v ɚ r aɪ d	oʊ v ɚ r oʊ d
r aɪ d	r oʊ d
r aɪ t	r oʊ t
r aɪ z	r oʊ z
r i r aɪ t	r i r oʊ t
s m aɪ t	s m oʊ t
s p i k	s p oʊ k
s t i l	s t oʊ l
s t r aɪ d	s t r oʊ d
s t r aɪ v	s t r oʊ v
s w eɪ r	s w oʊ r
ʃ aɪ n	ʃ oʊ n
t eɪ r	t oʊ r
ʧ u z	ʧ oʊ z
ʌ n d ɚ r aɪ t	ʌ n d ɚ r oʊ t
w eɪ k	w oʊ k
w eɪ r	w oʊ r
w i v	w oʊ v











d ɪ ɡ	d ʌ ɡ
f l ɪ ŋ	f l ʌ ŋ
h æ m s t r ɪ ŋ	h æ m s t r ʌ ŋ
h æ ŋ	h ʌ ŋ
k l ɪ ŋ	k l ʌ ŋ
oʊ v ɚ h æ ŋ	oʊ v ɚ h ʌ ŋ
r ɪ ŋ	r ʌ ŋ
s l ɪ ŋ	s l ʌ ŋ
s l ɪ ŋ k	s l ʌ ŋ k
s n i k	s n ʌ k
s p ɪ n	s p ʌ n
s p r ɪ ŋ	s p r ʌ ŋ
s t ɪ k	s t ʌ k
s t ɪ ŋ	s t ʌ ŋ
s t ɪ ŋ k	s t ʌ ŋ k
s t r aɪ k	s t r ʌ k
s t r ɪ ŋ	s t r ʌ ŋ
s w ɪ ŋ	s w ʌ ŋ
ʃ r ɪ ŋ k	ʃ r ʌ ŋ k
w ɪ n	w ʌ n



b a t ə l f i d	b a t ə l f ɛ d
b ɪ f ɔ l	b ɪ f ɛ l
b ɪ h oʊ l d	b ɪ h ɛ l d
b l i d	b l ɛ d
b r ɛ s t f i d	b r ɛ s t f ɛ d
b r i d	b r ɛ d
f i d	f ɛ d
f oʊ r s f i d	f oʊ r s f ɛ d
f ɔ l	f ɛ l
h oʊ l d	h ɛ l d
l i d	l ɛ d
m i t	m ɛ t
m ɪ s l i d	m ɪ s l ɛ d
m ɪ s r i d	m ɪ s r ɛ d
r i d	r ɛ d
s p i d	s p ɛ d
ʌ p h oʊ l d	ʌ p h ɛ l d
w ɪ θ h oʊ l d	w ɪ θ h ɛ l d




b ɪ ɡ ɪ n	b ɪ ɡ æ n
s ɪ t	s æ t
r ʌ n	r æ n
d r ɪ ŋ k	d r æ ŋ k
r ɪ ŋ	r æ ŋ
s ɪ ŋ	s æ ŋ
s ɪ ŋ k	s æ ŋ k
s w ɪ m	s w æ m
s p r ɪ ŋ	s p r æ ŋ
ʃ r ɪ ŋ k	ʃ r æ ŋ k
f ɚ b ɪ d	f ɚ b æ d
s p ɪ t	s p æ t
s t ɪ ŋ k	s t æ ŋ k
oʊ v ɚ r ʌ n	oʊ v ɚ r æ n
aʊ t r ʌ n	aʊ t r æ n






d i l	d ɛ l t
d r i m	d r ɛ m t
f i l	f ɛ l t
k i p	k ɛ p t
k r i p	k r ɛ p t
l i p	l ɛ p t
m i n	m ɛ n t
n i l	n ɛ l t
oʊ v ɚ s l i p	oʊ v ɚ s l ɛ p t
s l i p	s l ɛ p t
s w i p	s w ɛ p t
w i p	w ɛ p t




aʊ t ɡ r oʊ	aʊ t ɡ r u
b l oʊ	b l u
d r ɔ	d r u
f l aɪ	f l u
ɡ r oʊ	ɡ r u
n oʊ	n u
oʊ v ɚ d r ɔ	oʊ v ɚ d r u
oʊ v ɚ θ r oʊ	oʊ v ɚ θ r u
s l eɪ	s l u
w ɪ θ d r ɔ	w ɪ θ d r u
θ r oʊ	θ r u



b ɛ n d	b ɛ n t
b ɪ l d	b ɪ l t
l ɛ n d	l ɛ n t
r ɛ n d	r ɛ n t
r i b ɪ l d	r i b ɪ l t
s ɛ n d	s ɛ n t
s p ɛ n d	s p ɛ n t



k ʌ m	k eɪ m
ɡ ɪ v	ɡ eɪ v
b ɪ k ʌ m	b ɪ k eɪ m
l aɪ	l eɪ
i t	eɪ t
f ɚ ɡ ɪ v	f ɚ ɡ eɪ v
f ɚ b ɪ d	f ɚ b eɪ d
ʌ n d ɚ l aɪ	ʌ n d ɚ l eɪ
oʊ v ɚ k ʌ m	oʊ v ɚ k eɪ m
oʊ v ɚ r i t	oʊ v ɚ r eɪ t





b ɪ t eɪ k	b ɪ t ʊ k
f oʊ r s eɪ k	f oʊ r s ʊ k
m ɪ s t eɪ k	m ɪ s t ʊ k
oʊ v ɚ t eɪ k	oʊ v ɚ t ʊ k
p a r t eɪ k	p a r t ʊ k
ʃ eɪ k	ʃ ʊ k
t eɪ k	t ʊ k
ʌ n d ɚ t eɪ k	ʌ n d ɚ t ʊ k








θ ɪ ŋ k	θ ɔ t
b r ɪ ŋ	b r ɔ t
k æ ʧ	k ɔ t
t i ʧ	t ɔ t
f aɪ t	f ɔ t
s i k	s ɔ t
r i θ ɪ ŋ k	r i θ ɔ t
b ɪ s i ʧ	b ɪ s ɔ t






b aɪ n d	b aʊ n d
f aɪ n d	f aʊ n d
ɡ r aɪ n d	ɡ r aʊ n d
ʌ n b aɪ n d	ʌ n b aʊ n d
ʌ n w aɪ n d	ʌ n w aʊ n d
w aɪ n d	w aʊ n d







ɡ ɛ t	ɡ a t
b ɪ ɡ ɛ t	b ɪ ɡ a t
f ɚ ɡ ɛ t	f ɚ ɡ a t
ʃ u t	ʃ a t
oʊ v ɚ ʃ u t	oʊ v ɚ ʃ a t
t r ɛ d	t r a d



h aɪ d	h ɪ d
l aɪ t	l ɪ t
s l aɪ d	s l ɪ d
b aɪ t	b ɪ t
b æ k s l aɪ d	b æ k s l ɪ d



s ɛ l	s oʊ l d
aʊ t s ɛ l	aʊ t s oʊ l d
t ɛ l	t oʊ l d
f oʊ r t ɛ l	f oʊ r t oʊ l d
r i t ɛ l	r i t oʊ l d




f l i	f l ɛ d
s eɪ	s ɛ d










ɡ oʊ	w ɛ n t
f oʊ r ɡ oʊ	f oʊ r w ɛ n t
ʌ n d ɚ ɡ oʊ	ʌ n d ɚ w ɛ n t


d u	d ɪ d
r i d u	r i d ɪ d
ʌ n d u	ʌ n d ɪ d
aʊ t d u	aʊ t d ɪ d
oʊ v ɚ d u	oʊ v ɚ d ɪ d



s t æ n d	s t ʊ d
m ɪ s ʌ n d ɚ s t æ n d	m ɪ s ʌ n d ɚ s t ʊ d
ʌ n d ɚ s t æ n d	ʌ n d ɚ s t ʊ d
w ɪ θ s t æ n d	w ɪ θ s t ʊ d


s i	s ɔ
oʊ v ɚ s i	oʊ v ɚ s ɔ
f oʊ r s i	f oʊ r s ɔ

h i r	h ɚ d
oʊ v ɚ h i r	oʊ v ɚ h ɚ d

b aɪ	b ɔ t

l u z	l ɔ s t

l i v	l ɛ f t


