a g e t e	a g e m a s u
a k e t e	a k e m a s u
a i t e	a k i m a s u
a o i d e	a o g i m a s u
a ɾ a t t e	a ɾ a i m a s u
a t t e	a ɾ i m a s u
a ɾ u i t e	a ɾ u k i m a s u
a s o n d e	a s o b i m a s u
a t a t a m a t t e	a t a t a m a ɾ i m a s u
a t͡s u m a t t e	a t͡s u m a ɾ i m a s u
a t͡s u m e t e	a t͡s u m e m a s u
a t t e	a i m a s u
a w a t e t e	a w a t e m a s u
b u t͡s u k a t t e	b u t͡s u k a ɾ i m a s u
b u t͡s u k e t e	b u t͡s u k e m a s u
t͡ɕ i g a t t e	t͡ɕ i g a i m a s u
t͡ɕ i t t e	t͡ɕ i ɾ i m a s u
d a i t e	d a k i m a s u
d a m a t t e	d a m a ɾ i m a s u
d a m a ɕ i t e	d a m a ɕ i m a s u
d a ɕ i t e	d a s i m a s u
d e k a k e t e	d e k a k e m a s u
d e k i t e	d e k i m a s u
d e t e	d e m a s u
e ɾ a n d e	e ɾ a b i m a s u
e t e	e m a s u
ɸ u e t e	ɸ u e m a s u
ɸ u i t e	ɸ u k i m a s u
ɸ u n d e	ɸ u m i m a s u
ɸ u ɾ e t e	ɸ u ɾ e m a s u
ɸ u t t e	ɸ u ɾ i m a s u
ɸ u s e t e	ɸ u s e m a s u
ɸ u t o t t e	ɸ u t o ɾ i m a s u
g a n b a t t e	g a n b a ɾ i m a s u
h a g e m a ɕ i t e	h a g e m a ɕ i m a s u
h a g e n d e	h a g e m i m a s u
h a i t t e	h a i ɾ i m a s u
h a d͡ʑ i m a t t e	h a d͡ʑ i m a ɾ i m a s u
h a d͡ʑ i m e t e	h a d͡ʑ i m e m a s u
h a k a t t e	h a k a ɾ i m a s u
h a k o n d e	h a k o b i m a s u
h a i t e	h a k i m a s u
h a n a ɾ e t e	h a n a ɾ e m a s u
h a n a ɕ i t e	h a n a ɕ i m a s u
h a ɾ a t t e	h a ɾ a i m a s u
h a ɾ e t e	h a ɾ e m a s u
h a t t e	h a ɾ i m a s u
h a s a n d e	h a s a m i m a s u
h a ɕ i t t e	h a ɕ i ɾ i m a s u
h a t a ɾ a i t e	h a t a ɾ a k i m a s u
h a j a t t e	h a j a ɾ i m a s u
h a z u ɾ e t e	h a z u ɾ e m a s u
h a z u ɕ i t e	h a z u ɕ i m a s u
h e ɾ a ɕ i t e	h e ɾ a ɕ i m a s u
h e t e	h e m a s u
h i k a t t e	h i k a ɾ i m a s u
h i k i u k e t e	h i k i u k e m a s u
h i i t e	h i k i m a s u
h i n e t e	h i n e m a s u
h i ɾ a i t e	h i ɾ a k i m a s u
h i ɾ o m a t t e	h i ɾ o m a ɾ i m a s u
h i ɾ o m e t e	h i ɾ o m e m a s u
h i ɾ o t t e	h i ɾ o i m a s u
h i j a k a ɕ i t e	h i j a k a ɕ i m a s u
h i j a ɕ i t e	h i j a ɕ i m a s u
h o d o k e t e	h o d o k e m a s u
h o d o i t e	h o d o k i m a s u
h o m e t e	h o m e m a s u
h o n o m e k a ɕ i t e	h o n o m e k a ɕ i m a s u
h o ɾ e t e	h o ɾ e m a s u
h o ɾ o b i t e	h o ɾ o b i m a s u
h o ɾ o b o ɕ i t e	h o ɾ o b o s i m a s u
h o t t e	h o ɾ i m a s u
h o ɕ i g a t t e	h o ɕ i g a ɾ i m a s u
h o ɕ i t e	h o ɕ i m a s u
i b a t t e	i b a ɾ i m a s u
i i a ɾ a w a ɕ i t e	i i a ɾ a w a s u
i i d a ɕ i t e	i i d a ɕ i m a s u
i i ɸ u ɾ a ɕ i t e	i i ɸ u ɾ a ɕ i m a s u
i i k a e ɕ i t e	i i k a e ɕ i m a s u
i i t͡s u k e t e	i i t͡s u k e m a s u
i d͡ʑ i m e t e	i d͡ʑ i m e m a s u
i k i t e	i k i m a s u
i t t e	i k i m a s u
i m a ɕ i m e t e	i m a ɕ i m e m a s u
i n o t t e	i n o ɾ i m a s u
i ɾ e t e	i ɾ e m a s u
i t t e	i ɾ i m a s u
i s o i d e	i s o g i m a s u
i t a n d e	i t a m i m a s u
i t͡s u w a t t e	i t͡s u w a ɾ i m a s u
i t t e	i i m a s u
i w a t t e	i w a i m a s u
i j a g a t t e	i j a g a ɾ i m a s u
d͡ʑ u k u ɕ i t e	d͡ʑ u k u ɕ i m a s u
k a b a t t e	k a b a i m a s u
k a b u t t e	k a b u ɾ i m a s u
k a e t t e	k a e ɾ i m a s u
k a e ɕ i t e	k a e ɕ i m a s u
k a g a j a i t e	k a g a j a k i m a s u
k a g i t e	k a g i ɾ i m a s u
k a d͡ʑ i t e	k a d͡ʑ i m a s u
k a k a e t e	k a k a e m a s u
k a k a g e t e	k a k a g e m a s u
k a k a t t e	k a k a ɾ i m a s u
k a k a w a t t e	k a k a w a ɾ i m a s u
k a k e t e	k a k e m a s u
k a k o n d e	k a k o m i m a s u
k a i t e	k a k i m a s u
k a k u ɾ e t e	k a k u ɾ e m a s u
k a k u ɕ i t e	k a k u ɕ i m a s u
k a m a e t e	k a m a e m a s u
k a m a t t e	k a m a i m a s u
k a n d e	k a m i m a s u
k a n a ɕ i n d e	k a n a ɕ i m i m a s u
k a n a t t e	k a n a i m a s u
k a ŋ g a e t e	k a ŋ g a e m a s u
k a n d͡ʑ i t e	k a n d͡ʑ i m a s u
k a ɾ a k a t t e	k a ɾ a k a i m a s u
k a ɾ e t e	k a ɾ e m a s u
k a ɾ i t e	k a ɾ i m a s u
k a s a n a t t e	k a s a n a ɾ i m a s u
k a s a n e t e	k a s a n e m a s u
k a s e i d e	k a s e g i m a s u
k a ɕ i t e	k a ɕ i m a s u
k a s u n d e	k a s u m i m a s u
k a t a m a t t e	k a t a m a ɾ i m a s u
k a t a m e t e	k a t a m e m a s u
k a t a m u i t e	k a t a m u k i m a s u
k a t a z u k e t e	k a t a z u k e m a s u
k a t t e	k a t͡ɕ i m a s u
k a t͡s u i d e	k a t͡s u g i m a s u
k a t t e	k a i m a s u
k a w a i g a t t e	k a w a i g a ɾ i m a s u
k a w a k a ɕ i t e	k a w a k a ɕ i m a s u
k a w a i t e	k a w a k i m a s u
k a w a t t e	k a w a ɾ i m a s u
k a j o t t e	k a j o i m a s u
k a z a t t e	k a z a ɾ i m a s u
k a z o e t e	k a z o e m a s u
k e t e	k e m a s u
k e ɕ i t e	k e ɕ i m a s u
k i e t e	k i e m a s u
k i k a e t e	k i k a e m a s u
k i k o e t e	k i k o e m a s u
k i i t e	k i k i m a s u
k i m a t t e	k i m a ɾ i m a s u
k i m e t e	k i m e m a s u
k i n d͡ʑ i t e	k i n d͡ʑ i m a s u
k i ɾ e t e	k i ɾ e m a s u
k i t e	k i ɾ i m a s u
k i z u k a t t e	k i z u k a i m a s u
k i z u i t e	k i z u k i m a s u
k i z u t͡s u k e t e	k i z u t͡s u k e m a s u
k o b o ɾ e t e	k o b o ɾ e m a s u
k o b o ɕ i t e	k o b o ɕ i m a s u
k o e t e	k o e m a s u
k o g e t e	k o g e m a s u
k o k o ɾ o z a ɕ i t e	k o k o ɾ o z a ɕ i m a s u
k o m a t t e	k o m a ɾ i m a s u
k o n d e	k o m i m a s u
k o n o n d e	k o n o m i m a s u
k o ɾ a ɕ i t e	k o ɾ a ɕ i m a s u
k o ɾ o n d e	k o ɾ o b i m a s u
k o ɾ o ɕ i t e	k o ɾ o ɕ i m a s u
k o ɕ i k a k e t e	k o ɕ i k a k e m a s u
k o ɕ i ɾ a e t e	k o ɕ i ɾ a e m a s u
k o ɕ i t e	k o ɕ i m a s u
k o t a e t e	k o t a e m a s u
k o t o n a t t e	k o t o n a ɾ i m a s u
k o t o w a t t e	k o t o w a ɾ i m a s u
k o w a g a t t e	k o w a g a ɾ i m a s u
k o w a ɾ e t e	k o w a ɾ e m a s u
k o w a ɕ i t e	k o w a ɕ i m a s u
k u d a i t e	k u d a k i m a s u
k u d o i t e	k u d o k i m a s u
k u i t͡ɕ i g a t t e	k u i t͡ɕ i g a i m a s u
k u m o t t e	k u m o ɾ i m a s u
k u n d e	k u m i m a s u
k u ɾ a b e t e	k u ɾ a b e m a s u
k u ɾ a n d e	k u ɾ a m i m a s u
k u ɾ a ɕ i t e	k u ɾ a ɕ i m a s u
k u ɾ i k a e ɕ i t e	k u ɾ i k a e ɕ i m a s u
k u ɾ u ɕ i m e t e	k u ɾ u ɕ i m e m a s u
k u ɾ u ɕ i n d e	k u ɾ u ɕ i m i m a s u
k u ɾ u t t e	k u ɾ u i m a s u
k u s a t t e	k u s a ɾ i m a s u
k u w a d a t e t e	k u w a d a t e m a s u
k u w a e t e	k u w a e m a s u
k u z u ɾ e t e	k u z u ɾ e m a s u
k u z u ɕ i t e	k u z u ɕ i m a s u
m a t͡ɕ i g a e t e	m a t͡ɕ i g a e m a s u
m a t͡ɕ i g a t t e	m a t͡ɕ i g a i m a s u
m a g a t t e	m a g a ɾ i m a s u
m a g e t e	m a g e m a s u
m a d͡ʑ i t e	m a d͡ʑ i m a s u
m a k a ɕ i t e	m a k a ɕ i m a s u
m a k e t e	m a k e m a s u
m a m o t t e	m a m o ɾ i m a s u
m a n a n d e	m a n a b i m a s u
m a n e i t e	m a n e k i m a s u
m a t t e	m a t͡ɕ i m a s u
m a t͡s u t t e	m a t͡s u ɾ i m a s u
m a j o t t e	m a j o i m a s u
m a z e t e	m a z e m a s u
m e d a t t e	m e d a t͡ɕ i m a s u
m i e t e	m i e m a s u
m i g a i t e	m i g a k i m a s u
m i h a t t e	m i h a ɾ i m a s u
m i n a ɕ i t e	m i n a ɕ i m a s u
m i n o g a ɕ i t e	m i n o g a ɕ i m a s u
m i n o t t e	m i n o ɾ i m a s u
m i t e	m i m a s u
m i s e t e	m i s e m a s u
m i t o m e t e	m i t o m e m a s u
m i t͡s u k a t t e	m i t͡s u k a ɾ i m a s u
m i t͡s u k e t e	m i t͡s u k e m a s u
m o d o t t e	m o d o ɾ i m a s u
m o d o ɕ i t e	m o d o ɕ i m a s u
m o u k a t t e	m o u k a ɾ i m a s u
m o u k e t e	m o u k e m a s u
m o ɾ a ɕ i t e	m o ɾ a ɕ i m a s u
m o ɾ a t t e	m o ɾ a i m a s u
m o ɾ e t e	m o ɾ e m a s u
m o t e t e	m o t e m a s u
m o t o m e t e	m o t o m e m a s u
m o t o z u i t e	m o t o z u k i m a s u
m o t t e	m o t͡ɕ i m a s u
m u k a e t e	m u k a e m a s u
m u k a t t e	m u k a i m a s u
m u s u n d e	m u s u b i m a s u
n a g a m e t e	n a g a m e m a s u
n a g a ɾ e t e	n a g a ɾ e m a s u
n a g a ɕ i t e	n a g a ɕ i m a s u
n a g e t e	n a g e m a s u
n a g u t t e	n a g u ɾ i m a s u
n a g u s a m e t e	n a g u s a m e m a s u
n a d͡ʑ i n d e	n a d͡ʑ i m i m a s u
n a i t e	n a k i m a s u
n a k u n a t t e	n a k u n a ɾ i m a s u
n a k u ɕ i t e	n a k u ɕ i m a s u
n a m a k e t e	n a m a k e m a s u
n a m e t e	n a m e m a s u
n a o t t e	n a o ɾ i m a s u
n a o ɕ i t e	n a o ɕ i m a s u
n a ɾ a b e t e	n a ɾ a b e m a s u
n a ɾ a n d e	n a ɾ a b i m a s u
n a ɾ a t t e	n a ɾ a i m a s u
n a ɾ e t e	n a ɾ e m a s u
n a t t e	n a ɾ i m a s u
n e m u t t e	n e m u ɾ i m a s u
n e t e	n e m a s u
n i g e t e	n i g e m a s u
n i g i t e	n i g i ɾ i m a s u
n i ɾ a n d e	n i ɾ a m i m a s u
n i t e	n i m a s u
n o b a ɕ i t e	n o b a ɕ i m a s u
n o b o t t e	n o b o ɾ i m a s u
n o k o t t e	n o k o ɾ i m a s u
n o k o ɕ i t e	n o k o ɕ i m a s u
n o n d e	n o m i m a s u
n o t t e	n o ɾ i m a s u
n o s e t e	n o s e m a s u
n u i d e	n u g i m a s u
n u ɾ e t e	n u ɾ e m a s u
n u t t e	n u ɾ i m a s u
n u s u n d e	n u s u m i m a s u
o b o e t e	o b o e m a s u
o t͡ɕ i t e	o t͡ɕ i m a s u
o d o ɾ o i t e	o d o ɾ o k i m a s u
o d o t t e	o d o ɾ i m a s u
o k i t e	o k i m a s u
o k o t t e	o k o ɾ i m a s u
o i t e	o k i m a s u
o k u ɾ e t e	o k u ɾ e m a s u
o m o t t e	o m o i m a s u
o ɾ e t e	o ɾ e m a s u
o ɾ i t e	o ɾ i m a s u
o s a e t e	o s a e m a s u
o ɕ i e t e	o ɕ i e m a s u
o ɕ i n d e	o ɕ i m i m a s u
o s o ɾ e t e	o s o ɾ e m a s u
o s o t t e	o s o i m a s u
o ɕ i t e	o ɕ i m a s u
o t o t t e	o t o ɾ i m a s u
o t o ɕ i t e	o t o ɕ i m a s u
o t t e	o i m a s u
o w a t t e	o w a ɾ i m a s u
o j o n d e	o j o b i m a s u
o j o i d e	o j o g i m a s u
s a d a m e t e	s a d a m e m a s u
s a g a t t e	s a g a ɾ i m a s u
s a g a ɕ i t e	s a g a ɕ i m a s u
s a g e t e	s a g e m a s u
s a k e t e	s a k e m a s u
s a i t e	s a k i m a s u
s a m a t a g e t e	s a m a t a g e m a s u
s a s a e t e	s a s a e m a s u
s a s o t t e	s a s o i m a s u
s a ɕ i t e	s a ɕ i m a s u
s a w a i d e	s a w a g i m a s u
s a w a t t e	s a w a ɾ i m a s u
ɕ a b e t e	ɕ a b e ɾ i m a s u
ɕ i b a t t e	ɕ i b a ɾ i m a s u
ɕ i k a t t e	ɕ i k a ɾ i m a s u
ɕ i i t e	ɕ i k i m a s u
ɕ i m a t t e	ɕ i m a ɾ i m a s u
ɕ i m a t t e	ɕ i m a i m a s u
ɕ i m e t e	ɕ i m e m a s u
ɕ i m e ɕ i t e	ɕ i m e ɕ i m a s u
ɕ i n d͡ʑ i t e	ɕ i n d͡ʑ i m a s u
ɕ i n d e	ɕ i n i m a s u
ɕ i ɾ a b e t e	ɕ i ɾ a b e m a s u
ɕ i t t e	ɕ i ɾ i m a s u
ɕ i z u m a t t e	ɕ i z u m a ɾ i m a s u
ɕ i z u n d e	ɕ i z u m i m a s u
s o d a t e t e	s o d a t e m a s u
s o d a t t e	s o d a t͡ɕ i m a s u
s u b e t t e	s u b e ɾ i m a s u
s u g i t e	s u g i m a s u
s u g u ɾ e t e	s u g u ɾ e m a s u
s u i t e	s u k i m a s u
s u k u t t e	s u k u i m a s u
s u n d e	s u m i m a s u
ɕ i t e	ɕ i m a s u
s u s u n d e	s u s u m i m a s u
s u t e t e	s u t e m a s u
s u t t e	s u i m a s u
s u w a t t e	s u w a ɾ i m a s u
t a b e t e	t a b e m a s u
t a k u ɾ a n d e	t a k u ɾ a m i m a s u
t a k u w a e t e	t a k u w a e m a s u
t a m a t t e	t a m a ɾ i m a s u
t a m e t e	t a m e m a s u
t a m e ɕ i t e	t a m e ɕ i m a s u
t a n o n d e	t a n o m i m a s u
t a n o ɕ i n d e	t a n o ɕ i m i m a s u
t a o ɾ e t e	t a o ɾ e m a s u
t a o ɕ i t e	t a o ɕ i m a s u
t a ɾ i t e	t a ɾ i m a s u
t a ɕ i t e	t a ɕ i m a s u
t a s u k e t e	t a s u k e m a s u
t a t a k a t t e	t a t a k a i m a s u
t a t a n d e	t a t a m i m a s u
t a t e t e	t a t e m a s u
t a t t e	t a t͡ɕ i m a s u
t a j o t t e	t a j o ɾ i m a s u
t e t͡s u d a t t e	t e t͡s u d a i m a s u
t o n d e	t o b i m a s u
t o k e t e	t o k e m a s u
t o i t e	t o k i m a s u
t o m a t t e	t o m a ɾ i m a s u
t o m e t e	t o m e m a s u
t o ɾ e t e	t o ɾ e m a s u
t o ɾ i k a e t e	t o ɾ i k a e m a s u
t o t t e	t o ɾ i m a s u
t͡s u i d e	t͡s u g i m a s u
t͡s u k a n d e	t͡s u k a m i m a s u
t͡s u k a ɾ e t e	t͡s u k a ɾ e m a s u
t͡s u k a t t e	t͡s u k a i m a s u
t͡s u k e t e	t͡s u k e m a s u
t͡s u i t e	t͡s u k i m a s u
t͡s u k u t t e	t͡s u k u ɾ i m a s u
t͡s u m o t t e	t͡s u m o ɾ i m a s u
t͡s u n a i d e	t͡s u n a g i m a s u
t͡s u t o m e t e	t͡s u t o m e m a s u
t͡s u t͡s u n d e	t͡s u t͡s u m i m a s u
t͡s u j o m a t t e	t͡s u j o m a ɾ i m a s u
t͡s u j o m e t e	t͡s u j o m e m a s u
t͡s u z u k e t e	t͡s u z u k e m a s u
t͡s u z u i t e	t͡s u z u k i m a s u
u e t e	u e m a s u
u g o k a ɕ i t e	u g o k a ɕ i m a s u
u g o i t e	u g o k i m a s u
u k a n d e	u k a b i m a s u
u k e t o t t e	u k e t o ɾ i m a s u
u n d e	u m i m a s u
u ɾ a n d e	u ɾ a m i m a s u
u t t e	u ɾ i m a s u
u t a g a t t e	u t a g a i m a s u
u t a t t e	u t a i m a s u
u t t e	u t͡ɕ i m a s u
u t͡s u ɕ i t e	u t͡s u ɕ i m a s u
u w a m a w a t t e	u w a m a w a ɾ i m a s u
w a k a ɾ e t e	w a k a ɾ e m a s u
w a k a t t e	w a k a ɾ i m a s u
w a k e t e	w a k e m a s u
w a ɾ a t t e	w a ɾ a i m a s u
w a t t e	w a ɾ i m a s u
w a s u ɾ e t e	w a s u ɾ e m a s u
w a t a t t e	w a t a ɾ i m a s u
w a t a ɕ i t e	w a t a ɕ i m a s u
j a b u ɾ e t e	j a b u ɾ e m a s u
j a b u t t e	j a b u ɾ i m a s u
j a k e t e	j a k e m a s u
j a i t e	j a k i m a s u
j a m e t e	j a m e m a s u
j a t t e	j a ɾ i m a s u
j a s e t e	j a s e m a s u
j a s u n d e	j a s u m i m a s u
j a t o t t e	j a t o i m a s u
j o n d e	j o b i m a s u
j o n d e	j o m i m a s u
j o ɾ o k o n d e	j o ɾ o k o b i m a s u
j o t t e	j o ɾ i m a s u
j o t t e	j o i m a s u
j u ɾ u ɕ i t e	j u ɾ u ɕ i m a s u
