a g e ɾ u	a g e t e
a k e ɾ u	a k e t e
a k u	a i t e
a o g u	a o i d e
a ɾ a u	a ɾ a t t e
a ɾ u	a t t e
a ɾ u k u	a ɾ u i t e
a s o b u	a s o n d e
a t a t a m a ɾ u	a t a t a m a t t e
a t͡s u m a ɾ u	a t͡s u m a t t e
a t͡s u m e ɾ u	a t͡s u m e t e
a u	a t t e
a w a t e ɾ u	a w a t e t e
b u t͡s u k a ɾ u	b u t͡s u k a t t e
b u t͡s u k e ɾ u	b u t͡s u k e t e
t͡ɕ i g a u	t͡ɕ i g a t t e
t͡ɕ i ɾ u	t͡ɕ i t t e
d a k u	d a i t e
d a m a ɾ u	d a m a t t e
d a m a s u	d a m a ɕ i t e
d a s u	d a ɕ i t e
d e k a k e ɾ u	d e k a k e t e
d e k i ɾ u	d e k i t e
d e ɾ u	d e t e
e ɾ a b u	e ɾ a n d e
e ɾ u	e t e
ɸ u e ɾ u	ɸ u e t e
ɸ u k u	ɸ u i t e
ɸ u m u	ɸ u n d e
ɸ u ɾ e ɾ u	ɸ u ɾ e t e
ɸ u ɾ u	ɸ u t t e
ɸ u s e ɾ u	ɸ u s e t e
ɸ u t o ɾ u	ɸ u t o t t e
g a n b a ɾ u	g a n b a t t e
h a g e m a s u	h a g e m a ɕ i t e
h a g e m u	h a g e n d e
h a i ɾ u	h a i t t e
h a d͡ʑ i m a ɾ u	h a d͡ʑ i m a t t e
h a d͡ʑ i m e ɾ u	h a d͡ʑ i m e t e
h a k a ɾ u	h a k a t t e
h a k o b u	h a k o n d e
h a k u	h a i t e
h a n a ɾ e ɾ u	h a n a ɾ e t e
h a n a s u	h a n a ɕ i t e
h a ɾ a u	h a ɾ a t t e
h a ɾ e ɾ u	h a ɾ e t e
h a ɾ u	h a t t e
h a s a m u	h a s a n d e
h a ɕ i ɾ u	h a ɕ i t t e
h a t a ɾ a k u	h a t a ɾ a i t e
h a j a ɾ u	h a j a t t e
h a z u ɾ e ɾ u	h a z u ɾ e t e
h a z u s u	h a z u ɕ i t e
h e ɾ a s u	h e ɾ a ɕ i t e
h e ɾ u	h e t e
h i k a ɾ u	h i k a t t e
h i k i u k e ɾ u	h i k i u k e t e
h i k u	h i i t e
h i n e ɾ u	h i n e t e
h i ɾ a k u	h i ɾ a i t e
h i ɾ o m a ɾ u	h i ɾ o m a t t e
h i ɾ o m e ɾ u	h i ɾ o m e t e
h i ɾ o u	h i ɾ o t t e
h i j a k a s u	h i j a k a ɕ i t e
h i j a s u	h i j a ɕ i t e
h o d o k e ɾ u	h o d o k e t e
h o d o k u	h o d o i t e
h o m e ɾ u	h o m e t e
h o n o m e k a s u	h o n o m e k a ɕ i t e
h o ɾ e ɾ u	h o ɾ e t e
h o ɾ o b i ɾ u	h o ɾ o b i t e
h o ɾ o b o s u	h o ɾ o b o ɕ i t e
h o ɾ u	h o t t e
h o ɕ i g a ɾ u	h o ɕ i g a t t e
h o s u	h o ɕ i t e
i b a ɾ u	i b a t t e
i i a ɾ a w a s u	i i a ɾ a w a ɕ i t e
i i d a s u	i i d a ɕ i t e
i i ɸ u ɾ a s u	i i ɸ u ɾ a ɕ i t e
i i k a e s u	i i k a e ɕ i t e
i i t͡s u k e ɾ u	i i t͡s u k e t e
i d͡ʑ i m e ɾ u	i d͡ʑ i m e t e
i k i ɾ u	i k i t e
i k u	i t t e
i m a ɕ i m e ɾ u	i m a ɕ i m e t e
i n o ɾ u	i n o t t e
i ɾ e ɾ u	i ɾ e t e
i ɾ u	i t t e
i s o g u	i s o i d e
i t a m u	i t a n d e
i t͡s u w a ɾ u	i t͡s u w a t t e
i u	i t t e
i w a u	i w a t t e
i j a g a ɾ u	i j a g a t t e
d͡ʑ u k u s u	d͡ʑ u k u ɕ i t e
k a b a u	k a b a t t e
k a b u ɾ u	k a b u t t e
k a e ɾ u	k a e t t e
k a e s u	k a e ɕ i t e
k a g a j a k u	k a g a j a i t e
k a g i ɾ u	k a g i t e
k a d͡ʑ i ɾ u	k a d͡ʑ i t e
k a k a e ɾ u	k a k a e t e
k a k a g e ɾ u	k a k a g e t e
k a k a ɾ u	k a k a t t e
k a k a w a ɾ u	k a k a w a t t e
k a k e ɾ u	k a k e t e
k a k o m u	k a k o n d e
k a k u	k a i t e
k a k u ɾ e ɾ u	k a k u ɾ e t e
k a k u s u	k a k u ɕ i t e
k a m a e ɾ u	k a m a e t e
k a m a u	k a m a t t e
k a m u	k a n d e
k a n a ɕ i m u	k a n a ɕ i n d e
k a n a u	k a n a t t e
k a ŋ g a e ɾ u	k a ŋ g a e t e
k a n d͡ʑ i ɾ u	k a n d͡ʑ i t e
k a ɾ a k a u	k a ɾ a k a t t e
k a ɾ e ɾ u	k a ɾ e t e
k a ɾ i ɾ u	k a ɾ i t e
k a s a n a ɾ u	k a s a n a t t e
k a s a n e ɾ u	k a s a n e t e
k a s e g u	k a s e i d e
k a s u	k a ɕ i t e
k a s u m u	k a s u n d e
k a t a m a ɾ u	k a t a m a t t e
k a t a m e ɾ u	k a t a m e t e
k a t a m u k u	k a t a m u i t e
k a t a z u k e ɾ u	k a t a z u k e t e
k a t͡s u	k a t t e
k a t͡s u g u	k a t͡s u i d e
k a u	k a t t e
k a w a i g a ɾ u	k a w a i g a t t e
k a w a k a s u	k a w a k a ɕ i t e
k a w a k u	k a w a i t e
k a w a ɾ u	k a w a t t e
k a j o u	k a j o t t e
k a z a ɾ u	k a z a t t e
k a z o e ɾ u	k a z o e t e
k e ɾ u	k e t e
k e s u	k e ɕ i t e
k i e ɾ u	k i e t e
k i k a e ɾ u	k i k a e t e
k i k o e ɾ u	k i k o e t e
k i k u	k i i t e
k i m a ɾ u	k i m a t t e
k i m e ɾ u	k i m e t e
k i n d͡ʑ i ɾ u	k i n d͡ʑ i t e
k i ɾ e ɾ u	k i ɾ e t e
k i ɾ u	k i t e
k i z u k a u	k i z u k a t t e
k i z u k u	k i z u i t e
k i z u t͡s u k e ɾ u	k i z u t͡s u k e t e
k o b o ɾ e ɾ u	k o b o ɾ e t e
k o b o s u	k o b o ɕ i t e
k o e ɾ u	k o e t e
k o g e ɾ u	k o g e t e
k o k o ɾ o z a s u	k o k o ɾ o z a ɕ i t e
k o m a ɾ u	k o m a t t e
k o m u	k o n d e
k o n o m u	k o n o n d e
k o ɾ a s u	k o ɾ a ɕ i t e
k o ɾ o b u	k o ɾ o n d e
k o ɾ o s u	k o ɾ o ɕ i t e
k o ɕ i k a k e ɾ u	k o ɕ i k a k e t e
k o ɕ i ɾ a e ɾ u	k o ɕ i ɾ a e t e
k o s u	k o ɕ i t e
k o t a e ɾ u	k o t a e t e
k o t o n a ɾ u	k o t o n a t t e
k o t o w a ɾ u	k o t o w a t t e
k o w a g a ɾ u	k o w a g a t t e
k o w a ɾ e ɾ u	k o w a ɾ e t e
k o w a s u	k o w a ɕ i t e
k u d a k u	k u d a i t e
k u d o k u	k u d o i t e
k u i t͡ɕ i g a u	k u i t͡ɕ i g a t t e
k u m o ɾ u	k u m o t t e
k u m u	k u n d e
k u ɾ a b e ɾ u	k u ɾ a b e t e
k u ɾ a m u	k u ɾ a n d e
k u ɾ a s u	k u ɾ a ɕ i t e
k u ɾ i k a e s u	k u ɾ i k a e ɕ i t e
k u ɾ u ɕ i m e ɾ u	k u ɾ u ɕ i m e t e
k u ɾ u ɕ i m u	k u ɾ u ɕ i n d e
k u ɾ u u	k u ɾ u t t e
k u s a ɾ u	k u s a t t e
k u w a d a t e ɾ u	k u w a d a t e t e
k u w a e ɾ u	k u w a e t e
k u z u ɾ e ɾ u	k u z u ɾ e t e
k u z u s u	k u z u ɕ i t e
m a t͡ɕ i g a e ɾ u	m a t͡ɕ i g a e t e
m a t͡ɕ i g a u	m a t͡ɕ i g a t t e
m a g a ɾ u	m a g a t t e
m a g e ɾ u	m a g e t e
m a d͡ʑ i ɾ u	m a d͡ʑ i t e
m a k a s u	m a k a ɕ i t e
m a k e ɾ u	m a k e t e
m a m o ɾ u	m a m o t t e
m a n a b u	m a n a n d e
m a n e k u	m a n e i t e
m a t͡s u	m a t t e
m a t͡s u ɾ u	m a t͡s u t t e
m a j o u	m a j o t t e
m a z e ɾ u	m a z e t e
m e d a t͡s u	m e d a t t e
m i e ɾ u	m i e t e
m i g a k u	m i g a i t e
m i h a ɾ u	m i h a t t e
m i n a s u	m i n a ɕ i t e
m i n o g a s u	m i n o g a ɕ i t e
m i n o ɾ u	m i n o t t e
m i ɾ u	m i t e
m i s e ɾ u	m i s e t e
m i t o m e ɾ u	m i t o m e t e
m i t͡s u k a ɾ u	m i t͡s u k a t t e
m i t͡s u k e ɾ u	m i t͡s u k e t e
m o d o ɾ u	m o d o t t e
m o d o s u	m o d o ɕ i t e
m o u k a ɾ u	m o u k a t t e
m o u k e ɾ u	m o u k e t e
m o ɾ a s u	m o ɾ a ɕ i t e
m o ɾ a u	m o ɾ a t t e
m o ɾ e ɾ u	m o ɾ e t e
m o t e ɾ u	m o t e t e
m o t o m e ɾ u	m o t o m e t e
m o t o z u k u	m o t o z u i t e
m o t͡s u	m o t t e
m u k a e ɾ u	m u k a e t e
m u k a u	m u k a t t e
m u s u b u	m u s u n d e
n a g a m e ɾ u	n a g a m e t e
n a g a ɾ e ɾ u	n a g a ɾ e t e
n a g a s u	n a g a ɕ i t e
n a g e ɾ u	n a g e t e
n a g u ɾ u	n a g u t t e
n a g u s a m e ɾ u	n a g u s a m e t e
n a d͡ʑ i m u	n a d͡ʑ i n d e
n a k u	n a i t e
n a k u n a ɾ u	n a k u n a t t e
n a k u s u	n a k u ɕ i t e
n a m a k e ɾ u	n a m a k e t e
n a m e ɾ u	n a m e t e
n a o ɾ u	n a o t t e
n a o s u	n a o ɕ i t e
n a ɾ a b e ɾ u	n a ɾ a b e t e
n a ɾ a b u	n a ɾ a n d e
n a ɾ a u	n a ɾ a t t e
n a ɾ e ɾ u	n a ɾ e t e
n a ɾ u	n a t t e
n e m u ɾ u	n e m u t t e
n e ɾ u	n e t e
n i g e ɾ u	n i g e t e
n i g i ɾ u	n i g i t e
n i ɾ a m u	n i ɾ a n d e
n i ɾ u	n i t e
n o b a s u	n o b a ɕ i t e
n o b o ɾ u	n o b o t t e
n o k o ɾ u	n o k o t t e
n o k o s u	n o k o ɕ i t e
n o m u	n o n d e
n o ɾ u	n o t t e
n o s e ɾ u	n o s e t e
n u g u	n u i d e
n u ɾ e ɾ u	n u ɾ e t e
n u ɾ u	n u t t e
n u s u m u	n u s u n d e
o b o e ɾ u	o b o e t e
o t͡ɕ i ɾ u	o t͡ɕ i t e
o d o ɾ o k u	o d o ɾ o i t e
o d o ɾ u	o d o t t e
o k i ɾ u	o k i t e
o k o ɾ u	o k o t t e
o k u	o i t e
o k u ɾ e ɾ u	o k u ɾ e t e
o m o u	o m o t t e
o ɾ e ɾ u	o ɾ e t e
o ɾ i ɾ u	o ɾ i t e
o s a e ɾ u	o s a e t e
o ɕ i e ɾ u	o ɕ i e t e
o ɕ i m u	o ɕ i n d e
o s o ɾ e ɾ u	o s o ɾ e t e
o s o u	o s o t t e
o s u	o ɕ i t e
o t o ɾ u	o t o t t e
o t o s u	o t o ɕ i t e
o u	o t t e
o w a ɾ u	o w a t t e
o j o b u	o j o n d e
o j o g u	o j o i d e
s a d a m e ɾ u	s a d a m e t e
s a g a ɾ u	s a g a t t e
s a g a s u	s a g a ɕ i t e
s a g e ɾ u	s a g e t e
s a k e ɾ u	s a k e t e
s a k u	s a i t e
s a m a t a g e ɾ u	s a m a t a g e t e
s a s a e ɾ u	s a s a e t e
s a s o u	s a s o t t e
s a s u	s a ɕ i t e
s a w a g u	s a w a i d e
s a w a ɾ u	s a w a t t e
ɕ a b e ɾ u	ɕ a b e t e
ɕ i b a ɾ u	ɕ i b a t t e
ɕ i k a ɾ u	ɕ i k a t t e
ɕ i k u	ɕ i i t e
ɕ i m a ɾ u	ɕ i m a t t e
ɕ i m a u	ɕ i m a t t e
ɕ i m e ɾ u	ɕ i m e t e
ɕ i m e s u	ɕ i m e ɕ i t e
ɕ i n d͡ʑ i ɾ u	ɕ i n d͡ʑ i t e
ɕ i n u	ɕ i n d e
ɕ i ɾ a b e ɾ u	ɕ i ɾ a b e t e
ɕ i ɾ u	ɕ i t t e
ɕ i z u m a ɾ u	ɕ i z u m a t t e
ɕ i z u m u	ɕ i z u n d e
s o d a t e ɾ u	s o d a t e t e
s o d a t͡s u	s o d a t t e
s u b e ɾ u	s u b e t t e
s u g i ɾ u	s u g i t e
s u g u ɾ e ɾ u	s u g u ɾ e t e
s u k u	s u i t e
s u k u u	s u k u t t e
s u m u	s u n d e
s u ɾ u	ɕ i t e
s u s u m u	s u s u n d e
s u t e ɾ u	s u t e t e
s u u	s u t t e
s u w a ɾ u	s u w a t t e
t a b e ɾ u	t a b e t e
t a k u ɾ a m u	t a k u ɾ a n d e
t a k u w a e ɾ u	t a k u w a e t e
t a m a ɾ u	t a m a t t e
t a m e ɾ u	t a m e t e
t a m e s u	t a m e ɕ i t e
t a n o m u	t a n o n d e
t a n o ɕ i m u	t a n o ɕ i n d e
t a o ɾ e ɾ u	t a o ɾ e t e
t a o s u	t a o ɕ i t e
t a ɾ i ɾ u	t a ɾ i t e
t a s u	t a ɕ i t e
t a s u k e ɾ u	t a s u k e t e
t a t a k a u	t a t a k a t t e
t a t a m u	t a t a n d e
t a t e ɾ u	t a t e t e
t a t͡s u	t a t t e
t a j o ɾ u	t a j o t t e
t e t͡s u d a u	t e t͡s u d a t t e
t o b u	t o n d e
t o k e ɾ u	t o k e t e
t o k u	t o i t e
t o m a ɾ u	t o m a t t e
t o m e ɾ u	t o m e t e
t o ɾ e ɾ u	t o ɾ e t e
t o ɾ i k a e ɾ u	t o ɾ i k a e t e
t o ɾ u	t o t t e
t͡s u g u	t͡s u i d e
t͡s u k a m u	t͡s u k a n d e
t͡s u k a ɾ e ɾ u	t͡s u k a ɾ e t e
t͡s u k a u	t͡s u k a t t e
t͡s u k e ɾ u	t͡s u k e t e
t͡s u k u	t͡s u i t e
t͡s u k u ɾ u	t͡s u k u t t e
t͡s u m o ɾ u	t͡s u m o t t e
t͡s u n a g u	t͡s u n a i d e
t͡s u t o m e ɾ u	t͡s u t o m e t e
t͡s u t͡s u m u	t͡s u t͡s u n d e
t͡s u j o m a ɾ u	t͡s u j o m a t t e
t͡s u j o m e ɾ u	t͡s u j o m e t e
t͡s u z u k e ɾ u	t͡s u z u k e t e
t͡s u z u k u	t͡s u z u i t e
u e ɾ u	u e t e
u g o k a s u	u g o k a ɕ i t e
u g o k u	u g o i t e
u k a b u	u k a n d e
u k e t o ɾ u	u k e t o t t e
u m u	u n d e
u ɾ a m u	u ɾ a n d e
u ɾ u	u t t e
u t a g a u	u t a g a t t e
u t a u	u t a t t e
u t͡s u	u t t e
u t͡s u s u	u t͡s u ɕ i t e
u w a m a w a ɾ u	u w a m a w a t t e
w a k a ɾ e ɾ u	w a k a ɾ e t e
w a k a ɾ u	w a k a t t e
w a k e ɾ u	w a k e t e
w a ɾ a u	w a ɾ a t t e
w a ɾ u	w a t t e
w a s u ɾ e ɾ u	w a s u ɾ e t e
w a t a ɾ u	w a t a t t e
w a t a s u	w a t a ɕ i t e
j a b u ɾ e ɾ u	j a b u ɾ e t e
j a b u ɾ u	j a b u t t e
j a k e ɾ u	j a k e t e
j a k u	j a i t e
j a m e ɾ u	j a m e t e
j a ɾ u	j a t t e
j a s e ɾ u	j a s e t e
j a s u m u	j a s u n d e
j a t o u	j a t o t t e
j o b u	j o n d e
j o m u	j o n d e
j o ɾ o k o b u	j o ɾ o k o n d e
j o ɾ u	j o t t e
j o u	j o t t e
j u ɾ u s u	j u ɾ u ɕ i t e
