a b o n e	a b o n e
a b ʁ y t i	a b ʁ y t i
a p s ã	a p s ã t
a k s i d ã t e	a k s i d ã t e
a k õ p a ɲ a t œ ʁ	a k õ p a ɲ a t ʁ i s
a k o ʁ d e	a k o ʁ d e
a k u ʃ œ ʁ	a k u ʃ ø z
a k y z e	a k y z e
a ʃ t œ ʁ	a ʃ t ø z
a k t œ ʁ	a k t ʁ i s
a d ʒ w ɛ̃	a d ʒ w ɛ̃ t
a d m i n i s t ʁ a t œ ʁ	a d m i n i s t ʁ a t ʁ i s
a d m i n i s t ʁ a t i f	a d m i n i s t ʁ a t i v
a d m i n i s t ʁ e	a d m i n i s t ʁ e
a d m i ʁ a t œ ʁ	a d m i ʁ a t ʁ i s
a d o l e s ã	a d o l e s ã t
a d o p t e	a d o p t e
a d o ʁ a t œ ʁ	a d o ʁ a t ʁ i s
a f e ʁ e	a f e ʁ e
a f a m e	a f a m e
a f i l j e	a f i l j e
a f ʁ ã ʃ i	a f ʁ ã ʃ i
a f ɡ ã	a f ɡ a n
a f ʁ i k ɛ̃	a f ʁ i k ɛ n
a f ʁ o a m e ʁ i k ɛ̃	a f ʁ o a m e ʁ i k ɛ n
a f ʁ o k y b ɛ̃	a f ʁ o k y b ɛ n
a ʒ ã	a ʒ ã t
a ʒ i t a t œ ʁ	a ʒ i t a t ʁ i s
a ʒ i t e	a ʒ i t e
a ɡ o n i z ã	a ɡ o n i z ã t
a ɡ ʁ i k y l t œ ʁ	a ɡ ʁ i k y l t ʁ i s
a ɡ ʁ e ʒ e	a ɡ ʁ e ʒ e
a y ʁ i	a y ʁ i
e d s w a ɲ ã	e d s w a ɲ ã t
e ɡ ʁ i	e ɡ ʁ i
a l ʒ e ʁ j ɛ̃	a l ʒ e ʁ j ɛ n
a l j e n e	a l j e n e
a l m ã	a l m ã d
a l e	a l e
a l j e	a l j e
a l y m œ ʁ	a l y m ø z
a l y m e	a l y m e
a l z a s j ɛ̃	a l z a s j ɛ n
ã b a s a d œ ʁ	ã b a s a d ʁ i s
ã b y l ã s j e	ã b y l ã s j ɛ ʁ
a m i	a m i
a m n i s t j e	a m n i s t j e
a m e ʁ i k ɛ̃	a m e ʁ i k ɛ n
a m e ʁ ɛ̃ d j ɛ̃	a m e ʁ ɛ̃ d j ɛ n
a n a l i z e	a n a l i z e
ã s j ɛ̃	ã s j ɛ n
ã d a l u	ã d a l u z
ã ɡ l i k ã	ã ɡ l i k a n
ã ɡ w a s e	ã ɡ w a s e
a n i m a t œ ʁ	a n i m a t ʁ i s
a n õ s œ ʁ	a n õ s ø z
a n o ʁ m a l	a n o ʁ m a l
a p i k y l t œ ʁ	a p i k y l t ʁ i s
a p o s t a	a p o s t a t
a p ʁ ã t i	a p ʁ ã t i
a p ʁ e s j a t œ ʁ	a p ʁ e s j a t ʁ i s
a ʁ m e n j ɛ̃	a ʁ m e n j ɛ n
a ʁ n a k œ ʁ	a ʁ n a k ø z
a ʁ a ʃ œ ʁ	a ʁ a ʃ ø z
a ʁ i v ã	a ʁ i v ã t
a ʁ j e ʁ e	a ʁ j e ʁ e
a ʁ o ɡ ã	a ʁ o ɡ ã t
a ʁ o z œ ʁ	a ʁ o z ø z
a ʁ t i z ã	a ʁ t i z a n
a s o s j a l	a s o s j a l
a s p i ʁ ã	a s p i ʁ ã t
a s i s t ã	a s i s t ã t
a s j e ʒ e	a s j e ʒ e
a s o s j e	a s o s j e
a s y ʁ e	a s y ʁ e
a s t ʁ o f i z i s j ɛ̃	a s t ʁ o f i z i s j ɛ n
a t a ʃ e	a t a ʃ e
a t a k ã	a t a k ã t
a t a ʁ d e	a t a ʁ d e
o d i t œ ʁ	o d i t ʁ i s
o m o n j e	o m o n j ɛ ʁ
o t œ ʁ	o t œ ʁ
o t o s t o p œ ʁ	o t o s t o p ø z
o t ʁ i ʃ j ɛ̃	o t ʁ i ʃ j ɛ n
o v e ʁ ɲ a	o v e ʁ ɲ a t
a v a l œ ʁ	a v a l ø z
a v ã d e ʁ n j e	a v ã d e ʁ n j ɛ ʁ
a v ã t y ʁ j e	a v ã t y ʁ j ɛ ʁ
a v œ ɡ l ə n e	a v œ ɡ l ə n e
a v j a t œ ʁ	a v j a t ʁ i s
a v o k a	a v o k a t
a v o ʁ t œ ʁ	a v o ʁ t ø z
e n e	e n e
a j œ l	a j œ l
b a b w ɛ̃	b a b w i n
b a b i l o n j ɛ̃	b a b i l o n j ɛ n
b a ʃ ə l j e	b a ʃ ə l j ɛ ʁ
b a ɡ a ʁ œ ʁ	b a ɡ a ʁ ø z
b e ɲ œ ʁ	b e ɲ ø z
b e z œ ʁ	b e z ø z
b a l a d œ ʁ	b a l a d ø z
b a l e j œ ʁ	b a l e j ø z
b a l e n j e	b a l e n j ɛ ʁ
b ã b ɛ̃	b ã b i n
b ã l j ø z a ʁ	b ã l j ø z a ʁ d
b a n i	b a n i
b ã k j e	b ã k j ɛ ʁ
b a ʁ a t i n œ ʁ	b a ʁ a t i n ø z
b a ʁ õ	b a ʁ ɔ n
b a ʁ u d œ ʁ	b a ʁ u d ø z
b a ʁ œ ʁ	b a ʁ ø z
b a s k e t œ ʁ	b a s k e t ø z
b a t ã	b a t ã t
b a t œ ʁ	b a t ø z
b a v a ʁ	b a v a ʁ d
b a v œ ʁ	b a v ø z
b o	b ɛ l
b e l i ʒ e ʁ ã	b e l i ʒ e ʁ ã t
b ɛ̃ ʒ a m ɛ̃	b ɛ̃ ʒ a m i n
b e ʁ ʒ e	b e ʁ ʒ ɛ ʁ
b ø ɡ l ã	b ø ɡ l ã t
b œ ʁ e	b œ ʁ e
b j ɛ̃ n e m e	b j ɛ̃ n e m e
b j ɛ̃ f e t œ ʁ	b j ɛ̃ f e t ʁ i s
b i ɡ o	b i ɡ ɔ t
b i ʒ u t j e	b i ʒ u t j ɛ ʁ
b i ʁ m ã	b i ʁ m a n
b i z a j œ l	b i z a j œ l
b i s t ʁ o	b i s t ʁ ɔ t
b i s t ʁ o t j e	b i s t ʁ o t j ɛ ʁ
b l a ɡ œ ʁ	b l a ɡ ø z
b l ã ʃ i s œ ʁ	b l ã ʃ i s ø z
b l a s f e m a t œ ʁ	b l a s f e m a t ʁ i s
b l e s e	b l e s e
b l õ	b l õ d
b o e m j ɛ̃	b o e m j ɛ n
b o l i v j ɛ̃	b o l i v j ɛ n
b o s œ ʁ	b o s ø z
b u ʃ e	b u ʃ ɛ ʁ
b u d œ ʁ	b u d ø z
b u f œ ʁ	b u f ø z
b u f õ	b u f ɔ n
b u l ã ʒ e	b u l ã ʒ ɛ ʁ
b u k t j e	b u k t j ɛ ʁ
b u ʁ ɡ i ɲ õ	b u ʁ ɡ i ɲ ɔ n
b u ʁ s j e	b u ʁ s j ɛ ʁ
b u t i k j e	b u t i k j ɛ ʁ
b o k s œ ʁ	b o k s ø z
b ʁ a k o n j e	b ʁ a k o n j ɛ ʁ
b ʁ a j œ ʁ	b ʁ a j ø z
b ʁ ã	b ʁ ã d
b ʁ ã l œ ʁ	b ʁ ã l ø z
b ʁ a k œ ʁ	b ʁ a k ø z
b ʁ ə t õ	b ʁ ə t ɔ n
b ʁ i k o l œ ʁ	b ʁ i k o l ø z
b ʁ i z œ ʁ	b ʁ i z ø z
b ʁ o k ã t œ ʁ	b ʁ o k ã t ø z
b ʁ ɥ i t œ ʁ	b ʁ ɥ i t ø z
b ʁ e z i l j ɛ̃	b ʁ e z i l j ɛ n
b ʁ y l œ ʁ	b ʁ y l ø z
b ʁ y l e	b ʁ y l e
b y v œ ʁ	b y v ø z
b a t a ʁ	b a t a ʁ d
b a t i s œ ʁ	b a t i s ø z
b e d w ɛ̃	b e d w i n
b e n e d i k t ɛ̃	b e n e d i k t i n
b e o s j ɛ̃	b e o s j ɛ n
b e ʃ œ ʁ	b e ʃ ø z
b e t a	b e t a s
b y ʃ œ ʁ	b y ʃ ø z
k a b a ʁ ə t j e	k a b a ʁ ə t j ɛ ʁ
k a b o t ɛ̃	k a b o t i n
k a ʃ o t j e	k a ʃ o t j ɛ ʁ
k a d ɛ	k a d ɛ t
k a f a ʁ d œ ʁ	k a f a ʁ d ø z
k a f t œ ʁ	k a f t ø z
k a ɡ o	k a ɡ ɔ t
k e s j e	k e s j ɛ ʁ
k a ʒ o l œ ʁ	k a ʒ o l ø z
k a l i f o ʁ n j ɛ̃	k a l i f o ʁ n j ɛ n
k a l o m n j a t œ ʁ	k a l o m n j a t ʁ i s
k ã b o d ʒ j ɛ̃	k ã b o d ʒ j ɛ n
k ã b ʁ i j o l œ ʁ	k ã b ʁ i j o l ø z
k ã p œ ʁ	k ã p ø z
k ã d i d a	k ã d i d a t
k ã t i n j e	k ã t i n j ɛ ʁ
k a p o ʁ a l	k a p o ʁ a l
k a p t i f	k a p t i v
k a ʁ a v a n j e	k a ʁ a v a n j ɛ ʁ
k a ʁ d œ ʁ	k a ʁ d ø z
k a ʁ i j o n œ ʁ	k a ʁ i j o n ø z
k a ʁ n a s j e	k a ʁ n a s j ɛ ʁ
k a ʁ t o m ã s j ɛ̃	k a ʁ t o m ã s j ɛ n
k a s k a d œ ʁ	k a s k a d ø z
k a s œ ʁ	k a s ø z
k a s t i j ã	k a s t i j a n
k a t ʃ œ ʁ	k a t ʃ ø z
k o k a z j ɛ̃	k o k a z j ɛ n
k o z œ ʁ	k o z ø z
k a v a l œ ʁ	k a v a l ø z
k a v a l j e	k a v a l j ɛ ʁ
k a v i j õ	k a v i j ɔ n
s ã t ʁ i f y ʒ œ ʁ	s ã t ʁ i f y ʒ ø z
ʃ a y t œ ʁ	ʃ a y t ø z
ʃ a m o	ʃ a m ɛ l
ʃ ã p j õ	ʃ ã p j ɔ n
ʃ ã ʒ œ ʁ	ʃ ã ʒ ø z
ʃ ã t œ ʁ	ʃ ã t ø z
ʃ ã s a ʁ	ʃ ã s a ʁ d
ʃ a p a ʁ d œ ʁ	ʃ a p a ʁ d ø z
ʃ a ʁ k y t j e	ʃ a ʁ k y t j ɛ ʁ
ʃ a ʁ m œ ʁ	ʃ a ʁ m ø z
ʃ a ʁ p ã t j e	ʃ a ʁ p ã t j ɛ ʁ
ʃ a ʁ ə t j e	ʃ a ʁ ə t j ɛ ʁ
ʃ a s œ ʁ	ʃ a s ʁ ɛ s
ʃ a s œ ʁ	ʃ a s ø z
ʃ a	ʃ a t
ʃ o	ʃ o d
ʃ o f œ ʁ	ʃ o f ø z
ʃ o v ɛ̃	ʃ o v i n
ʃ e ʁ ʃ œ ʁ	ʃ e ʁ ʃ ø z
ʃ ə v ʁ i j e	ʃ ə v ʁ i j ɛ ʁ
ʃ j a l œ ʁ	ʃ j a l ø z
ʃ i k o	ʃ i k ɔ t
ʃ j ɛ̃	ʃ j ɛ n
ʃ j œ ʁ	ʃ j ø z
ʃ i f o n j e	ʃ i f o n j ɛ ʁ
ʃ i f ʁ œ ʁ	ʃ i f ʁ ø z
ʃ i n w a	ʃ i n w a z
k i ʁ o m ã s j ɛ̃	k i ʁ o m ã s j ɛ n
k i ʁ o p ʁ a t i s j ɛ̃	k i ʁ o p ʁ a t i s j ɛ n
ʃ i ʁ y ʁ ʒ j ɛ̃	ʃ i ʁ y ʁ ʒ j ɛ n
ʃ o k o l a t j e	ʃ o k o l a t j ɛ ʁ
ʃ u	ʃ u t
ʃ u ʁ a v œ ʁ	ʃ u ʁ a v ø z
k ʁ o n i k œ ʁ	k ʁ o n i k ø z
k ʁ e t j ɛ̃	k ʁ e t j ɛ n
ʃ a t l ɛ̃	ʃ a t l ɛ n
ʃ o m œ ʁ	ʃ o m ø z
s ɛ̃ ɡ l e	s ɛ̃ ɡ l e
s i ʁ œ ʁ	s i ʁ ø z
s i t a d ɛ̃	s i t a d i n
s i t w a j ɛ̃	s i t w a j ɛ n
s i v i l	s i v i l
k l ã d e s t ɛ̃	k l ã d e s t i n
k l i j ã	k l i j ã t
k l i n i s j ɛ̃	k l i n i s j ɛ n
k l o ʃ a ʁ	k l o ʃ a ʁ d
k l u œ ʁ	k l u ø z
k o ʃ õ	k o ʃ ɔ n
k o k y	k o k y
k o f õ d a t œ ʁ	k o f õ d a t ʁ i s
k o ɲ œ ʁ	k o ɲ ø z
k w a f œ ʁ	k w a f ø z
k o l a b o ʁ a t œ ʁ	k o l a b o ʁ a t ʁ i s
k o l ã	k o l ã t
k o l e k s j o n œ ʁ	k o l e k s j o n ø z
k o l e ʒ j ɛ̃	k o l e ʒ j ɛ n
k o l õ b j ɛ̃	k o l õ b j ɛ n
k o l o n ɛ l	k o l o n ɛ l
k o l p ɔ ʁ t œ ʁ	k o l p ɔ ʁ t ø z
k õ b a t ã	k õ b a t ã t
k o m ã t a t œ ʁ	k o m ã t a t ʁ i s
k o m e ʁ s j a l	k o m e ʁ s j a l
k o m e ʁ s ã	k o m e ʁ s ã t
k o m y n a l	k o m y n a l
k o m y n j ã	k o m y n j ã t
k õ p l o t œ ʁ	k õ p l o t ø z
k õ p o z ã	k õ p o z ã t
k õ p o z i t œ ʁ	k õ p o z i t ʁ i s
k õ p o z e	k õ p o z e
k õ p e t i t œ ʁ	k õ p e t i t ʁ i s
k õ t	k õ t ɛ s
k o m e d j ɛ̃	k o m e d j ɛ n
k õ	k ɔ n
k o n a ʁ	k o n a ʁ d
k õ s e p t œ ʁ	k õ s e p t ʁ i s
k õ s i l j a t œ ʁ	k õ s i l j a t ʁ i s
k õ s i t w a j ɛ̃	k õ s i t w a j ɛ n
k õ k y b ɛ̃	k õ k y b i n
k õ d a n e	k õ d a n e
k õ d y k t œ ʁ	k õ d y k t ʁ i s
k õ f e k s j o n œ ʁ	k õ f e k s j o n ø z
k õ f i d ã	k õ f i d ã t
k õ f i z œ ʁ	k õ f i z ø z
k õ f e ʁ ã s j e	k õ f e ʁ ã s j ɛ ʁ
k õ ʒ w ɛ̃	k õ ʒ w ɛ̃ t
k õ ʒ y ʁ e	k õ ʒ y ʁ e
k o n e s œ ʁ	k o n e s ø z
k õ k e ʁ ã	k õ k e ʁ ã t
k õ s e j e	k õ s e j ɛ ʁ
k õ s o l a t œ ʁ	k õ s o l a t ʁ i s
k õ s o m a t œ ʁ	k õ s o m a t ʁ i s
k õ s p i ʁ a t œ ʁ	k õ s p i ʁ a t ʁ i s
k õ s t i p e	k õ s t i p e
k õ s t i t ɥ ã	k õ s t i t ɥ ã t
k õ s y l t ã	k õ s y l t ã t
k õ t ã p l a t œ ʁ	k õ t ã p l a t ʁ i s
k õ t ã p o ʁ ɛ̃	k õ t ã p o ʁ ɛ n
k õ t œ ʁ	k õ t ø z
k õ t i n ã t a l	k õ t i n ã t a l
k õ t ʁ a k t ɥ ɛ l	k õ t ʁ a k t ɥ ɛ l
k õ t ʁ ə b ã d j e	k õ t ʁ ə b ã d j ɛ ʁ
k õ t ʁ o l œ ʁ	k õ t ʁ o l ø z
k õ v e ʁ t i	k õ v e ʁ t i
k õ v w a j œ ʁ	k õ v w a j ø z
k o o p e ʁ ã	k o o p e ʁ ã t
k o o ʁ d i n a t œ ʁ	k o o ʁ d i n a t ʁ i s
k o p ɛ̃	k o p i n
k o p j œ ʁ	k o p j ø z
k o k ɛ̃	k o k i n
k o ʁ d o	k o ʁ d ɛ l
k o ʁ d ə l j e	k o ʁ d ə l j ɛ ʁ
k o ʁ d o n j e	k o ʁ d o n j ɛ ʁ
k o ʁ e s p õ d ã	k o ʁ e s p õ d ã t
k o ʁ y p t œ ʁ	k o ʁ y p t ʁ i s
k o ʁ e ɛ̃	k o ʁ e ɛ n
k o s a ʁ	k o s a ʁ d
k o s t y m j e	k o s t y m j ɛ ʁ
k u ʃ œ ʁ	k u ʃ ø z
k u p œ ʁ	k u p ø z
k u ʁ œ ʁ	k u ʁ ø z
k u ʁ s j e	k u ʁ s j ɛ ʁ
k u ʁ t o	k u ʁ t o d
k u ʁ t j e	k u ʁ t j ɛ ʁ
k u ʁ t i z ã	k u ʁ t i z a n
k u z ɛ̃	k u z i n
k u t y ʁ j e	k u t y ʁ j ɛ ʁ
k o e k i p j e	k o e k i p j ɛ ʁ
k o e k i p j e	k o e k i p j ɛ ʁ
k ʁ a ʃ œ ʁ	k ʁ a ʃ ø z
k ʁ ə t õ	k ʁ ə t ɔ n
k ʁ ə v a ʁ	k ʁ ə v a ʁ d
k ʁ i j œ ʁ	k ʁ i j ø z
k ʁ i m i n ɛ l	k ʁ i m i n ɛ l
k ʁ o k œ ʁ	k ʁ o k ø z
k ʁ u l ã	k ʁ u l ã t
k ʁ w a j ã	k ʁ w a j ã t
k ʁ a n œ ʁ	k ʁ a n ø z
k ʁ e a t œ ʁ	k ʁ e a t ʁ i s
k ʁ e m j e	k ʁ e m j ɛ ʁ
k ʁ e t ɛ̃	k ʁ e t i n
k y b ɛ̃	k y b ɛ n
k œ j œ ʁ	k œ j ø z
k ɥ i z i n j e	k ɥ i z i n j ɛ ʁ
k y l o t j e	k y l o t j ɛ ʁ
k y l t i v a t œ ʁ	k y l t i v a t ʁ i s
k y ʁ a t œ ʁ	k y ʁ a t ʁ i s
k a l ɛ̃	k a l i n
d a l m a s j ɛ̃	d a l m a s j ɛ n
d a n e	d a n e
d ã s œ ʁ	d ã s ø z
d a ʁ õ	d a ʁ ɔ n
d o f ɛ̃	d o f i n
d ə m ã d œ ʁ	d ə m ã d ø z
d ə m ã d œ ʁ	d ə m ã d ʁ ɛ s
d ə m œ ʁ e	d ə m œ ʁ e
d ə m i	d ə m i
d ə m i m ɔ ʁ	d ə m i m ɔ ʁ t
d ə m i t õ	d ə m i t ɔ n
d e ʁ n j e	d e ʁ n j ɛ ʁ
d e s ã d ã	d e s ã d ã t
d e s i n a t œ ʁ	d e s i n a t ʁ i s
d e s t ʁ y k t œ ʁ	d e s t ʁ y k t ʁ i s
d ø v i n œ ʁ	d ø v i n ʁ ɛ s
d j a l e k t i s j ɛ̃	d j a l e k t i s j ɛ n
d i k t a t œ ʁ	d i k t a t ʁ i s
d i f a m a t œ ʁ	d i f a m a t ʁ i s
d i p l o m e	d i p l o m e
d i ʁ e k t œ ʁ	d i ʁ e k t ʁ i s
d i ʁ i ʒ ã	d i ʁ i ʒ ã t
d i z œ ʁ	d i z ø z
d i s p a ʁ y	d i s p a ʁ y
d i s p ã s a t œ ʁ	d i s p ã s a t ʁ i s
d i s t ʁ i b y t œ ʁ	d i s t ʁ i b y t ʁ i s
d i v i z œ ʁ	d i v i z ø z
d i v o ʁ s e	d i v o ʁ s e
d j e t e t i s j ɛ̃	d j e t e t i s j ɛ n
d o m i n a t œ ʁ	d o m i n a t ʁ i s
d o m i n i k ɛ̃	d o m i n i k ɛ n
d õ p t œ ʁ	d õ p t ø z
d o n a t œ ʁ	d o n a t ʁ i s
d o n œ ʁ	d o n ø z
d o ʁ m œ ʁ	d o ʁ m ø z
d u b l œ ʁ	d u b l ø z
d w a j ɛ̃	d w a j ɛ n
d ʁ a ɡ õ	d ʁ a ɡ ɔ n
d ʁ a ɡ œ ʁ	d ʁ a ɡ ø z
d ʁ e s œ ʁ	d ʁ e s ø z
d ʁ o ɡ e	d ʁ o ɡ e
d e b o ʃ e	d e b o ʃ e
d e b ʁ a j e	d e b ʁ a j e
d e b ʁ u j a ʁ	d e b ʁ u j a ʁ d
d e b y t ã	d e b y t ã t
d e k a d ã	d e k a d ã t
d e ʃ e n e	d e ʃ e n e
d e ʃ i k t œ ʁ	d e ʃ i k t ø z
d e k l a s e	d e k l a s e
d e k o d œ ʁ	d e k o d ø z
d e k o n œ ʁ	d e k o n ø z
d e k õ t ʁ a k t e	d e k õ t ʁ a k t e
d e k o ʁ a t œ ʁ	d e k o ʁ a t ʁ i s
d e k u p œ ʁ	d e k u p ø z
d e k u v ʁ œ ʁ	d e k u v ʁ ø z
d e f ã d œ ʁ	d e f ã d ʁ ɛ s
d e f œ̃	d e f œ̃ t
d e ɡ õ f l e	d e ɡ õ f l e
d e ɡ u ʁ d i	d e ɡ u ʁ d i
d e ɡ u t ã	d e ɡ u t ã t
d e ɡ u t e	d e ɡ u t e
d e ɡ i z e	d e ɡ i z e
d e ɡ y s t a t œ ʁ	d e ɡ y s t a t ʁ i s
d e ʒ e n e ʁ e	d e ʒ e n e ʁ e
d e l e s e	d e l e s e
d e l a t œ ʁ	d e l a t ʁ i s
d e l ɛ̃ k ã	d e l ɛ̃ k ã t
d e l e ɡ e	d e l e ɡ e
d e m a ʁ ʃ œ ʁ	d e m a ʁ ʃ ø z
d e m ã	d e m ã t
d e m o l i s œ ʁ	d e m o l i s ø z
d e m õ	d e m ɔ n
d e m õ s t ʁ a t œ ʁ	d e m õ s t ʁ a t ʁ i s
d e m y n i	d e m y n i
d e m e n a ʒ œ ʁ	d e m e n a ʒ ø z
d e n a t y ʁ e	d e n a t y ʁ e
d e n i ʃ œ ʁ	d e n i ʃ ø z
d e n õ s j a t œ ʁ	d e n õ s j a t ʁ i s
d e p a n œ ʁ	d e p a n ø z
d e p ə n a j e	d e p ə n a j e
d e p ã s j e	d e p ã s j ɛ ʁ
d e p l a s e	d e p l a s e
d e p o ʁ t e	d e p o ʁ t e
d e p ʁ a v e	d e p ʁ a v e
d e p ʁ i m e	d e p ʁ i m e
d e p y t e	d e p y t e
d e ʁ a s i n e	d e ʁ a s i n e
d e ʁ i v e	d e ʁ i v e
d e ʁ u l œ ʁ	d e ʁ u l ø z
d e z a b y z e	d e z a b y z e
d e z a p w ɛ̃ t e	d e z a p w ɛ̃ t e
d e z ã p a ʁ e	d e z ã p a ʁ e
d e z ã ʃ ã t e	d e z ã ʃ ã t e
d e z e s p e ʁ e	d e z e s p e ʁ e
d e z ɛ̃ k a ʁ n e	d e z ɛ̃ k a ʁ n e
d e z œ v ʁ e	d e z œ v ʁ e
d e z o ʁ d o n e	d e z o ʁ d o n e
d e z e k i l i b ʁ e	d e z e k i l i b ʁ e
d e t a ʃ e	d e t a ʃ e
d e t ã t œ ʁ	d e t ã t ʁ i s
d e t n y	d e t n y
d e t e ʁ œ ʁ	d e t e ʁ ø z
d e t e ʁ e	d e t e ʁ e
d e t ʁ a k e	d e t ʁ a k e
d e v e ʁ ɡ õ d e	d e v e ʁ ɡ õ d e
d e v j ã	d e v j ã t
d e v o ʁ œ ʁ	d e v o ʁ ø z
d e v o	d e v ɔ t
d e v w a j e	d e v w a j e
d e s y	d e s y
d i n œ ʁ	d i n ø z
e f ʁ õ t e	e f ʁ õ t e
ã b a l œ ʁ	ã b a l ø z
ã b o m œ ʁ	ã b o m ø z
ã b u t i s œ ʁ	ã b u t i s ø z
ã b ʁ a s œ ʁ	ã b ʁ a s ø z
ã m e ʁ d œ ʁ	ã m e ʁ d ø z
ã p l w a j e	ã p l w a j e
ã p w a z o n œ ʁ	ã p w a z o n ø z
ã p o ʁ t e	ã p o ʁ t e
ã p ʁ e s e	ã p ʁ e s e
ã p e ʃ œ ʁ	ã p e ʃ ø z
ã ʃ ã t œ ʁ	ã ʃ ã t ʁ ɛ s
ã ʃ e ʁ i s œ ʁ	ã ʃ e ʁ i s ø z
ã f l e	ã f l e
ã f w a ʁ e	ã f w a ʁ e
ã ʒ o l œ ʁ	ã ʒ o l ø z
e n m i	e n m i
ã k i k i n œ ʁ	ã k i k i n ø z
ã k e t œ ʁ	ã k e t ø z
ã ʁ a ʒ e	ã ʁ a ʒ e
ã ʁ ʒ i s t ʁ œ ʁ	ã ʁ ʒ i s t ʁ ø z
ã s e ɲ ã	ã s e ɲ ã t
ã s o ʁ s ə l œ ʁ	ã s o ʁ s ə l ø z
ã t ʁ e n œ ʁ	ã t ʁ e n ø z
ã t ʁ ə m e t œ ʁ	ã t ʁ ə m e t ø z
ã t ʁ ə p ʁ ə n œ ʁ	ã t ʁ ə p ʁ ə n ø z
ã t ʁ ə t ə n œ ʁ	ã t ʁ ə t ə n ø z
ã t e t e	ã t e t e
ã v l o p e	ã v l o p e
ã v w a j e	ã v w a j e
e s k a l a d œ ʁ	e s k a l a d ø z
e s p a ɲ ɔ l	e s p a ɲ ɔ l
e s p j õ	e s p j ɔ n
e s t e t i s j ɛ̃	e s t e t i s j ɛ n
e s t i v ã	e s t i v ã t
ø ʁ a z j ɛ̃	ø ʁ a z j ɛ n
ø ʁ o p e ɛ̃	ø ʁ o p e ɛ n
e k s a m ã	e k s a m ã t
e k s a s i s t ã	e k s a s i s t ã t
e k s ʃ ã p j õ	e k s ʃ ã p j ɔ n
e k s ʃ ã t œ ʁ	e k s ʃ ã t ø z
e k s f j ã s e	e k s f j ã s e
e k s p ə t i	e k s p ə t i t
e ɡ z a l t e	e ɡ z a l t e
e ɡ z a m i n a t œ ʁ	e ɡ z a m i n a t ʁ i s
e k s k a v a t œ ʁ	e k s k a v a t ʁ i s
e k s i t e	e k s i t e
e k s k l y	e k s k l y
e ɡ z i l e	e ɡ z i l e
e k s p l w a t ã	e k s p l w a t ã t
e k s p l o ʁ a t œ ʁ	e k s p l o ʁ a t ʁ i s
e k s p l o z i f	e k s p l o z i v
e k s p e d i t œ ʁ	e k s p e d i t ʁ i s
e k s t ʁ a v a ɡ ã	e k s t ʁ a v a ɡ ã t
e k s t ʁ a v ɛ ʁ t i	e k s t ʁ a v ɛ ʁ t i
e ɡ z e k y t œ ʁ	e ɡ z e k y t ʁ i s
f a b ʁ i k ã	f a b ʁ i k ã t
f a k t œ ʁ	f a k t ʁ i s
f a k t y ʁ j e	f a k t y ʁ j ɛ ʁ
f e n e ã	f e n e ã t
f ə z ã	f ə z a n
f ə z œ ʁ	f ə z ø z
f ã f a ʁ õ	f ã f a ʁ ɔ n
f a ʁ o	f a ʁ o d
f a ʁ s œ ʁ	f a ʁ s ø z
f o ʃ œ ʁ	f o ʃ ø z
f o t œ ʁ	f o t ʁ i s
f o t œ ʁ	f o t ø z
f e ɲ ã	f e ɲ ã t
f ɛ ʁ	f ɛ ʁ
f e ʁ m j e	f e ʁ m j ɛ ʁ
f e ʁ o n j e	f e ʁ o n j ɛ ʁ
f e s œ ʁ	f e s ø z
f j ã s e	f j ã s e
f i ɡ y ʁ ã	f i ɡ y ʁ ã t
f i l œ ʁ	f i l ø z
f i j œ l	f i j œ l
f i n ã s j e	f i n ã s j ɛ ʁ
f i n o	f i n o d
f i n i s œ ʁ	f i n i s ø z
f l e ʁ œ ʁ	f l e ʁ ø z
f l a m ã	f l a m ã d
f l ã b œ ʁ	f l ã b ø z
f l e m a ʁ	f l e m a ʁ d
f l ɛ̃ ɡ œ ʁ	f l ɛ̃ ɡ ø z
f l i p e	f l i p e
f l œ ʁ t œ ʁ	f l œ ʁ t ø z
f õ s œ ʁ	f õ s ø z
f õ d a t œ ʁ	f õ d a t ʁ i s
f u t b o l œ ʁ	f u t b o l ø z
f o ʁ ɛ̃	f o ʁ ɛ n
f o ʁ s ə n e	f o ʁ s ə n e
f o ʁ œ ʁ	f o ʁ ø z
f o ʁ ʒ ə ʁ õ	f o ʁ ʒ ə ʁ ɔ n
f o ʁ m a t œ ʁ	f o ʁ m a t ʁ i s
f o ʁ n i k a t œ ʁ	f o ʁ n i k a t ʁ i s
f u	f ɔ l
f w e t œ ʁ	f w e t ø z
f u j œ ʁ	f u j ø z
f w i n œ ʁ	f w i n ø z
f u ʁ m i l j e	f u ʁ m i l j ɛ ʁ
f ʁ e z œ ʁ	f ʁ e z ø z
f ʁ ã m a s õ	f ʁ ã m a s ɔ n
f ʁ ã ʒ ɛ̃	f ʁ ã ʒ i n
f ʁ ã s ɛ	f ʁ ã s ɛ z
f ʁ o d œ ʁ	f ʁ o d ø z
f ʁ i m œ ʁ	f ʁ i m ø z
f ʁ i p õ	f ʁ i p ɔ n
f ʁ o t œ ʁ	f ʁ o t ø z
f ʁ u s a ʁ	f ʁ u s a ʁ d
f ʁ ɥ i t j e	f ʁ ɥ i t j ɛ ʁ
f ʁ y s t ʁ e	f ʁ y s t ʁ e
f y ʒ i t i f	f y ʒ i t i v
f y ɡ œ ʁ	f y ɡ ø z
f y m œ ʁ	f y m ø z
f y m j e	f y m j ɛ ʁ
f y t e	f y t e
f ɥ i j a ʁ	f ɥ i j a ʁ d
f e d e ʁ a t œ ʁ	f e d e ʁ a t ʁ i s
f e l e	f e l e
ɡ a f œ ʁ	ɡ a f ø z
ɡ a ɲ ã	ɡ a ɲ ã t
ɡ a ɲ œ ʁ	ɡ a ɲ ø z
ɡ a j a ʁ	ɡ a j a ʁ d
ɡ a l ã	ɡ a l ã t
ɡ a l o p ɛ̃	ɡ a l o p i n
ɡ a m ɛ̃	ɡ a m i n
ɡ a ʁ ã	ɡ a ʁ ã t
ɡ a ʁ d œ ʁ	ɡ a ʁ d ø z
ɡ a ʁ d j ɛ̃	ɡ a ʁ d j ɛ n
ɡ o ʃ e	ɡ o ʃ ɛ ʁ
ʒ e ɲ a ʁ	ʒ e ɲ a ʁ d
ʒ e ʁ b j e	ʒ e ʁ b j ɛ ʁ
ʒ o l j e	ʒ o l j ɛ ʁ
ʒ i t ã	ʒ i t a n
ɡ l a n œ ʁ	ɡ l a n ø z
ɡ l u t õ	ɡ l u t ɔ n
ɡ o b œ ʁ	ɡ o b ø z
ɡ o l f œ ʁ	ɡ o l f ø z
ɡ õ d o l j e	ɡ õ d o l j ɛ ʁ
ɡ u ʁ m ã	ɡ u ʁ m ã d
ɡ u t œ ʁ	ɡ u t ø z
ɡ ʁ a m e ʁ j ɛ̃	ɡ ʁ a m e ʁ j ɛ n
ɡ ʁ ã	ɡ ʁ ã d
ɡ ʁ ɛ k	ɡ ʁ ɛ k
ɡ ʁ ə d ɛ̃	ɡ ʁ ə d i n
ɡ ʁ e f j e	ɡ ʁ e f j ɛ ʁ
ɡ ʁ ɛ̃ p œ ʁ	ɡ ʁ ɛ̃ p ø z
ɡ ʁ i p e	ɡ ʁ i p e
ɡ ʁ o	ɡ ʁ o s
ɡ ʁ y t j e	ɡ ʁ y t j ɛ ʁ
ɡ e t œ ʁ	ɡ e t ø z
ɡ ø l a ʁ	ɡ ø l a ʁ d
ɡ i ʃ t j e	ɡ i ʃ t j ɛ ʁ
ɡ e ʁ i s œ ʁ	ɡ e ʁ i s ø z
ʒ e ã	ʒ e ã t
ʒ e n i t œ ʁ	ʒ e n i t ʁ i s
ʒ e n e ʁ a l	ʒ e n e ʁ a l
ʒ e n e ʁ a t œ ʁ	ʒ e n e ʁ a t ʁ i s
ʒ e n e t i s j ɛ̃	ʒ e n e t i s j ɛ n
ʒ e ʁ ã	ʒ e ʁ ã t
ʒ e n œ ʁ	ʒ e n ø z
a b i j œ ʁ	a b i j ø z
a b i t ã	a b i t ã t
a b i t ɥ e	a b i t ɥ e
a l y s i n e	a l y s i n e
ã d i k a p e	ã d i k a p e
a ʁ s ə l œ ʁ	a ʁ s ə l ø z
a i s j ɛ̃	a i s j ɛ n
ɛ̃ d u	ɛ̃ d u
i s t o ʁ j ɛ̃	i s t o ʁ j ɛ n
i t l e ʁ j ɛ̃	i t l e ʁ j ɛ n
o ʁ l o ʒ e	o ʁ l o ʒ ɛ ʁ
y ɡ n o	y ɡ n ɔ t
y m ɛ̃	y m ɛ n
y ʁ õ	y ʁ ɔ n
y s a ʁ	y s a ʁ d
i p n o t i z œ ʁ	i p n o t i z ø z
e b e t e	e b e t e
e ʁ i t j e	e ʁ i t j ɛ ʁ
o t ə l j e	o t ə l j ɛ ʁ
i d j o	i d j ɔ t
i ɲ o ʁ ã	i ɲ o ʁ ã t
i l e t ʁ e	i l e t ʁ e
i l y m i n e	i l y m i n e
i l y s t ʁ a t œ ʁ	i l y s t ʁ a t ʁ i s
i m i t a t œ ʁ	i m i t a t ʁ i s
i m i ɡ ʁ ã	i m i ɡ ʁ ã t
i m i ɡ ʁ e	i m i ɡ ʁ e
i m o ʁ t ɛ l	i m o ʁ t ɛ l
ɛ̃ p a s j ã	ɛ̃ p a s j ã t
ɛ̃ p e ʁ t i n ã	ɛ̃ p e ʁ t i n ã t
ɛ̃ p o l i	ɛ̃ p o l i
ɛ̃ p o ʁ t œ̃	ɛ̃ p o ʁ t y n
ɛ̃ p o z e	ɛ̃ p o z e
ɛ̃ p o t ã	ɛ̃ p o t ã t
ɛ̃ p e t ʁ ã	ɛ̃ p e t ʁ ã t
i n a d a p t e	i n a d a p t e
ɛ̃ s ã d j e	ɛ̃ s ã d j e
ɛ̃ s i t a t œ ʁ	ɛ̃ s i t a t ʁ i s
ɛ̃ k õ d i s j o n ɛ l	ɛ̃ k õ d i s j o n ɛ l
ɛ̃ k o n y	ɛ̃ k o n y
ɛ̃ k õ s t ã	ɛ̃ k õ s t ã t
ɛ̃ k ʁ w a j ã	ɛ̃ k ʁ w a j ã t
ɛ̃ k y l p e	ɛ̃ k y l p e
ɛ̃ d j ɛ̃	ɛ̃ d j ɛ n
ɛ̃ d i f e ʁ ã	ɛ̃ d i f e ʁ ã t
ɛ̃ d i ʒ ã	ɛ̃ d i ʒ ã t
ɛ̃ d o n e z j ɛ̃	ɛ̃ d o n e z j ɛ n
ɛ̃ d y s t ʁ i j ɛ l	ɛ̃ d y s t ʁ i j ɛ l
ɛ̃ d e p ã d ã	ɛ̃ d e p ã d ã t
ɛ̃ f ã	ɛ̃ f ã t
ɛ̃ f i ʁ m j e	ɛ̃ f i ʁ m j ɛ ʁ
ɛ̃ f o ʁ m a t œ ʁ	ɛ̃ f o ʁ m a t ʁ i s
ɛ̃ f o ʁ m a t i s j ɛ̃	ɛ̃ f o ʁ m a t i s j ɛ n
ɛ̃ f e ʁ j œ ʁ	ɛ̃ f e ʁ j œ ʁ
ɛ̃ ɡ ʁ a	ɛ̃ ɡ ʁ a t
ɛ̃ ʒ e n y	ɛ̃ ʒ e n y
i n i s j a t œ ʁ	i n i s j a t ʁ i s
i n i s j e	i n i s j e
i n o s ã	i n o s ã t
i n õ d e	i n õ d e
ɛ̃ s k ʁ i	ɛ̃ s k ʁ i t
ɛ̃ s ã s e	ɛ̃ s ã s e
ɛ̃ s p e k t œ ʁ	ɛ̃ s p e k t ʁ i s
ɛ̃ s p i ʁ a t œ ʁ	ɛ̃ s p i ʁ a t ʁ i s
ɛ̃ s p i ʁ e	ɛ̃ s p i ʁ e
ɛ̃ s t i ɡ a t œ ʁ	ɛ̃ s t i ɡ a t ʁ i s
ɛ̃ s t i t y t œ ʁ	ɛ̃ s t i t y t ʁ i s
ɛ̃ s y l t e	ɛ̃ s y l t e
ɛ̃ s y ʁ ʒ e	ɛ̃ s y ʁ ʒ e
ɛ̃ t e l e k t ɥ ɛ l	ɛ̃ t e l e k t ɥ ɛ l
ɛ̃ t ã d ã	ɛ̃ t ã d ã t
ɛ̃ t e ʁ d i	ɛ̃ t e ʁ d i t
ɛ̃ t e ʁ l o k y t œ ʁ	ɛ̃ t e ʁ l o k y t ʁ i s
ɛ̃ t e ʁ m i t ã	ɛ̃ t e ʁ m i t ã t
ɛ̃ t e ʁ n a s j o n a l	ɛ̃ t e ʁ n a s j o n a l
ɛ̃ t e ʁ o ɡ a t œ ʁ	ɛ̃ t e ʁ o ɡ a t ʁ i s
ɛ̃ t e ʁ v ə n ã	ɛ̃ t e ʁ v ə n ã t
ɛ̃ t o k s i k e	ɛ̃ t o k s i k e
ɛ̃ t ʁ i ɡ ã	ɛ̃ t ʁ i ɡ ã t
ɛ̃ t ʁ o d y k t œ ʁ	ɛ̃ t ʁ o d y k t ʁ i s
ɛ̃ t ʁ o v e ʁ t i	ɛ̃ t ʁ o v e ʁ t i
ɛ̃ t ʁ y	ɛ̃ t ʁ y z
ɛ̃ t e ʁ e s ã	ɛ̃ t e ʁ e s ã t
ɛ̃ t e ʁ e s e	ɛ̃ t e ʁ e s e
ɛ̃ v e s t i ɡ a t œ ʁ	ɛ̃ v e s t i ɡ a t ʁ i s
ɛ̃ v i t e	ɛ̃ v i t e
i ʁ a n j ɛ̃	i ʁ a n j ɛ n
i ʁ e ɡ y l j e	i ʁ e ɡ y l j ɛ ʁ
i s ʁ a e l j ɛ̃	i s ʁ a e l j ɛ n
i t a l j ɛ̃	i t a l j ɛ n
ʒ a k a s œ ʁ	ʒ a k a s ø z
ʒ a m a i k ɛ̃	ʒ a m a i k ɛ n
ʒ ə t œ ʁ	ʒ ə t ø z
d ʒ o ɡ œ ʁ	d ʒ o ɡ ø z
ʒ õ ɡ l œ ʁ	ʒ õ ɡ l ø z
ʒ w œ ʁ	ʒ w ø z
ʒ w i s œ ʁ	ʒ w i s ø z
ʒ u t œ ʁ	ʒ u t ø z
ʒ u v ã s o	ʒ u v ã s ɛ l
ʒ ɥ i f	ʒ ɥ i v
ʒ y ʁ e	ʒ y ʁ e
ʒ y s t i s j e	ʒ y s t i s j ɛ ʁ
k o l k o z j ɛ̃	k o l k o z j ɛ n
l a b o ʁ ã t ɛ̃	l a b o ʁ ã t i n
l ɛ	l ɛ d
l e t j e	l e t j ɛ ʁ
l ã s œ ʁ	l ã s ø z
l a p ɛ̃	l a p i n
l a p õ	l a p ɔ n
l a t ɛ̃	l a t i n
l a t i n o a m e ʁ i k ɛ̃	l a t i n o a m e ʁ i k ɛ n
l a v œ ʁ	l a v ø z
l e k t œ ʁ	l e k t ʁ i s
l ə v œ ʁ	l ə v ø z
l i b e ʁ t ɛ̃	l i b e ʁ t i n
l i b ʁ ə p ã s œ ʁ	l i b ʁ ə p ã s ø z
l i b e ʁ a l	l i b e ʁ a l
l i b e ʁ a t œ ʁ	l i b e ʁ a t ʁ i s
l i s ã s j e	l i s ã s j e
l j œ ʁ	l j ø z
l i f t j e	l i f t j ɛ ʁ
l i m o n a d j e	l i m o n a d j ɛ ʁ
l i m o n j e	l i m o n j ɛ ʁ
l i m u z ɛ̃	l i m u z i n
l j õ	l j ɔ n
l i z œ ʁ	l i z ø z
l i v ʁ œ ʁ	l i v ʁ ø z
l o k y t œ ʁ	l o k y t ʁ i s
l o ʒ œ ʁ	l o ʒ ø z
l o ʒ i s j ɛ̃	l o ʒ i s j ɛ n
l o ʁ ɛ̃	l o ʁ ɛ n
l u b a ʁ	l u b a ʁ d
l u ʃ œ ʁ	l u ʃ ø z
l w œ ʁ	l w ø z
l u ʁ	l u ʁ d
l y ʁ õ	l y ʁ ɔ n
l y s t ʁ œ ʁ	l y s t ʁ ø z
l y t e ʁ j ɛ̃	l y t e ʁ j ɛ n
l y t œ ʁ	l y t ø z
l i s e ɛ̃	l i s e ɛ n
l a ʃ œ ʁ	l a ʃ ø z
l e ʃ œ ʁ	l e ʃ ø z
l e ʒ i s l a t i f	l e ʒ i s l a t i v
l e z a ʁ	l e z a ʁ d
m a b u l	m a b u l
m a ɡ a z i n j e	m a ɡ a z i n j ɛ ʁ
m a ɡ ʁ e b ɛ̃	m a ɡ ʁ e b i n
m a ʒ i s j ɛ̃	m a ʒ i s j ɛ n
m a ʒ i s t ʁ a	m a ʒ i s t ʁ a t
m e ɡ ʁ i ʃ õ	m e ɡ ʁ i ʃ ɔ n
m ɛ ʁ	m ɛ ʁ ɛ s
m a ʒ œ ʁ	m a ʒ œ ʁ
m a l e m e	m a l e m e
m a l b e z e	m a l b e z e
m a l a d ʁ w a	m a l a d ʁ w a t
m a l ɛ̃	m a l i n
m ã ʃ o	m ã ʃ ɔ t
m ã ʒ œ ʁ	m ã ʒ ø z
m a n j œ ʁ	m a n j ø z
m a n i f e s t ã	m a n i f e s t ã t
m a n i p y l a t œ ʁ	m a n i p y l a t ʁ i s
m a n ɥ ɛ l	m a n ɥ ɛ l
m a o ʁ i	m a o ʁ i
m a k ʁ o	m a k ʁ ɛ l
m a k i j œ ʁ	m a k i j ø z
m a k i z a ʁ	m a k i z a ʁ d
m a ʁ a t o n j ɛ̃	m a ʁ a t o n j ɛ n
m a ʁ o	m a ʁ o d
m a ʁ o d œ ʁ	m a ʁ o d ø z
m a ʁ e ʃ e	m a ʁ e ʃ ɛ ʁ
m a ʁ ʃ ã	m a ʁ ʃ ã d
m a ʁ ʃ œ ʁ	m a ʁ ʃ ø z
m a ʁ e j œ ʁ	m a ʁ e j ø z
m a ʁ j œ ʁ	m a ʁ j ø z
m a ʁ j e	m a ʁ j e
m a ʁ o k ɛ̃	m a ʁ o k ɛ n
m a ʁ ã	m a ʁ ã t
m a ʁ e ʃ a l	m a ʁ e ʃ a l
m a s œ ʁ	m a s ø z
m a t l a s j e	m a t l a s j ɛ ʁ
m a t œ ʁ	m a t ø z
m a t e m a t i s j ɛ̃	m a t e m a t i s j ɛ n
m a t õ	m a t ɔ n
m a s õ	m a s ɔ n
m e j œ ʁ	m e j œ ʁ
m ã d j ã	m ã d j ã t
m ã d i ɡ o	m ã d i ɡ ɔ t
m ə n œ ʁ	m ə n ø z
m ã t œ ʁ	m ã t ø z
m e ʁ s j e	m e ʁ s j ɛ ʁ
m e s a ʒ e	m e s a ʒ ɛ ʁ
m e t œ ʁ	m e t ø z
m ø n j e	m ø n j ɛ ʁ
m œ ʁ t ʁ i j e	m œ ʁ t ʁ i j ɛ ʁ
m e k s i k ɛ̃	m e k s i k ɛ n
m i ɲ õ	m i ɲ ɔ n
m i l i t ã	m i l i t ã t
m i n ɛ	m i n ɛ t
m i n œ ʁ	m i n œ ʁ
m i ʁ a k y l e	m i ʁ a k y l e
m i t ʁ a j œ ʁ	m i t ʁ a j ø z
m o d e ʁ e	m o d e ʁ e
m w a s o n œ ʁ	m w a s o n ø z
m o l a s õ	m o l a s ɔ n
m õ d ɛ̃	m õ d ɛ n
m õ ɡ ɔ l	m õ ɡ ɔ l
m õ ɡ o l j ɛ̃	m õ ɡ o l j ɛ n
m o n i t œ ʁ	m o n i t ʁ i s
m õ t a ɲ a ʁ	m õ t a ɲ a ʁ d
m õ t œ ʁ	m õ t ø z
m õ t ʁ œ ʁ	m õ t ʁ ø z
m o k œ ʁ	m o k ø z
m o ʁ i b õ	m o ʁ i b õ d
m o ʁ i k o	m o ʁ i k o d
m o ʁ m õ	m o ʁ m ɔ n
m o ʁ t ɛ l	m o ʁ t ɛ l
m o t a ʁ	m o t a ʁ d
m u ʃ a ʁ	m u ʃ a ʁ d
m u ʁ ã	m u ʁ ã t
m y z i s j ɛ̃	m y z i s j ɛ n
m y z y l m ã	m y z y l m a n
m y t ã	m y t ã t
m y t ɛ̃	m y t i n
m i s t i f i k a t œ ʁ	m i s t i f i k a t ʁ i s
m a ʃ œ ʁ	m a ʃ ø z
m e k a n i s j ɛ̃	m e k a n i s j ɛ n
m e k õ t ã	m e k õ t ã t
m e d a j e	m e d a j e
m e d j a t œ ʁ	m e d j a t ʁ i s
m e d i z ã	m e d i z ã t
m e n a ʒ e	m e n a ʒ ɛ ʁ
m e ʁ i d j ɛ̃	m e ʁ i d j ɛ n
m e t a f i z i s j ɛ̃	m e t a f i z i s j ɛ n
n a b o	n a b ɔ t
n a ʒ œ ʁ	n a ʒ ø z
n ɛ̃	n ɛ n
n ã t i	n ã t i
n a p o l i t ɛ̃	n a p o l i t ɛ n
n a ʁ a t œ ʁ	n a ʁ a t ʁ i s
n o f ʁ a ʒ œ ʁ	n o f ʁ a ʒ ø z
n o f ʁ a ʒ e	n o f ʁ a ʒ e
n a v i ɡ a t œ ʁ	n a v i ɡ a t ʁ i s
n a z i	n a z i
n e t w a j œ ʁ	n e t w a j ø z
n ø ʁ o ʃ i ʁ y ʁ ʒ j ɛ̃	n ø ʁ o ʃ i ʁ y ʁ ʒ j ɛ n
n i ɡ o	n i ɡ o d
n i v l œ ʁ	n i v l ø z
n o s œ ʁ	n o s ø z
n w a ʁ	n w a ʁ
n õ v j o l ã	n õ v j o l ã t
n õ v w a j ã	n õ v w a j ã t
n o ʁ k o ʁ e ɛ̃	n o ʁ k o ʁ e ɛ n
n o ʁ m ã	n o ʁ m ã d
n u ʁ i s j e	n u ʁ i s j ɛ ʁ
n u v o	n u v ɛ l
n w a j e	n w a j e
n y	n y
n ɛ ɡ ʁ	n ɛ ɡ ʁ ɛ s
n e k ʁ o m ã s j ɛ̃	n e k ʁ o m ã s j ɛ n
n e ɡ o s j ã	n e ɡ o s j ã t
n e ɡ o s j a t œ ʁ	n e ɡ o s j a t ʁ i s
n e ɡ ʁ i j e	n e ɡ ʁ i j ɛ ʁ
o b l i ʒ e	o b l i ʒ e
o p s e ʁ v a t œ ʁ	o p s e ʁ v a t ʁ i s
o p s t i n e	o p s t i n e
o p s t e t ʁ i s j ɛ̃	o p s t e t ʁ i s j ɛ n
o k s i d ã t a l	o k s i d ã t a l
o k y p ã	o k y p ã t
o f i s j ɛ l	o f i s j ɛ l
o f i s j e	o f i s j ɛ ʁ
w a z ə l j e	w a z ə l j ɛ ʁ
o p o z ã	o p o z ã t
o p ʁ i m e	o p ʁ i m e
o p t i s j ɛ̃	o p t i s j ɛ n
o p e ʁ a t œ ʁ	o p e ʁ a t ʁ i s
o ʁ ã	o ʁ ã t
o ʁ a t œ ʁ	o ʁ a t ʁ i s
o ʁ d o n a t œ ʁ	o ʁ d o n a t ʁ i s
o ʁ ɡ a n i z a t œ ʁ	o ʁ ɡ a n i z a t ʁ i s
o ʁ j ã t a l	o ʁ j ã t a l
o ʁ j ã t œ ʁ	o ʁ j ã t ø z
o ʁ i ʒ i n a l	o ʁ i ʒ i n a l
o ʁ f ə l ɛ̃	o ʁ f ə l i n
u ʁ s	u ʁ s
u ʁ s õ	u ʁ s ɔ n
u v ʁ œ ʁ	u v ʁ ø z
u v ʁ i j e	u v ʁ i j ɛ ʁ
p a s i f i k a t œ ʁ	p a s i f i k a t ʁ i s
p a l f ʁ ə n j e	p a l f ʁ ə n j ɛ ʁ
p a n t j e	p a n t j ɛ ʁ
p ã	p a n
p a ʁ a l i z e	p a ʁ a l i z e
p a ʁ ɛ j	p a ʁ ɛ j
p a ʁ ã	p a ʁ ã t
p a ʁ f ɛ	p a ʁ f ɛ t
p a ʁ f y m œ ʁ	p a ʁ f y m ø z
p a ʁ j œ ʁ	p a ʁ j ø z
p a ʁ i ɡ o	p a ʁ i ɡ ɔ t
p a ʁ i z j ɛ̃	p a ʁ i z j ɛ n
p a ʁ l œ ʁ	p a ʁ l ø z
p a ʁ w a s j ɛ̃	p a ʁ w a s j ɛ n
p a ʁ o l j e	p a ʁ o l j ɛ ʁ
p a ʁ p a j o	p a ʁ p a j ɔ t
p a ʁ k ə t œ ʁ	p a ʁ k ə t ø z
p a ʁ t i s i p ã	p a ʁ t i s i p ã t
p a ʁ t i k y l j e	p a ʁ t i k y l j ɛ ʁ
p a ʁ s j ɛ l	p a ʁ s j ɛ l
p a ʁ t i z ã	p a ʁ t i z a n
p a ʁ v ə n y	p a ʁ v ə n y
p a s a ʒ e	p a s a ʒ ɛ ʁ
p a s ã	p a s ã t
p a s m ã t j e	p a s m ã t j ɛ ʁ
p a s œ ʁ	p a s ø z
p a s t u ʁ o	p a s t u ʁ ɛ l
p a s j ã	p a s j ã t
p a t i n œ ʁ	p a t i n ø z
p a t ʁ i s j ɛ̃	p a t ʁ i s j ɛ n
p a t ʁ õ	p a t ʁ ɔ n
p o m e	p o m e
p e i z ã	p e i z a n
p a j ɛ̃	p a j ɛ n
p e l t œ ʁ	p e l t ø z
p ã d a ʁ	p ã d a ʁ d
p ã d y	p ã d y
p ã s œ ʁ	p ã s ø z
p e ʁ s ɛ p t œ ʁ	p e ʁ s ɛ p t ʁ i s
p e ʁ s œ ʁ	p e ʁ s ø z
p e ʁ d ã	p e ʁ d ã t
p e ʁ f o ʁ a t œ ʁ	p e ʁ f o ʁ a t ʁ i s
p e ʁ y k j e	p e ʁ y k j ɛ ʁ
p e ʁ s ã	p e ʁ s a n
p e s t i f e ʁ e	p e s t i f e ʁ e
p ə t i	p ə t i t
f a ʁ m a s j ɛ̃	f a ʁ m a s j ɛ n
f o t o k o p j œ ʁ	f o t o k o p j ø z
f i z i s j ɛ̃	f i z i s j ɛ n
p i ʒ õ	p i ʒ ɔ n
p i j a ʁ	p i j a ʁ d
p i j œ ʁ	p i j ø z
p j õ	p j ɔ n
p j o n j e	p j o n j ɛ ʁ
p i p œ ʁ	p i p ø z
p i k œ ʁ	p i k ø z
p i s œ ʁ	p i s ø z
p i s t o n e	p i s t o n e
p i t ʃ u n	p i t ʃ u n
p j e ʒ œ ʁ	p j e ʒ ø z
p l a s œ ʁ	p l a s ø z
p l a f o n j e	p l a f o n j ɛ ʁ
p l e ɲ ã	p l e ɲ ã t
p l a n i f i k a t œ ʁ	p l a n i f i k a t ʁ i s
p l a s t i s j ɛ̃	p l a s t i s j ɛ n
p l ø ʁ œ ʁ	p l ø ʁ ø z
p l œ ʁ n i ʃ œ ʁ	p l œ ʁ n i ʃ ø z
p l i j œ ʁ	p l i j ø z
p l õ ʒ œ ʁ	p l õ ʒ ø z
p l e b e j ɛ̃	p l e b e j ɛ n
p o ʃ a ʁ	p o ʃ a ʁ d
p w ɛ̃ t œ ʁ	p w ɛ̃ t ø z
p w a ʁ e	p w a ʁ e
p w a v ʁ o	p w a v ʁ ɔ t
p o l i s j e	p o l i s j ɛ ʁ
p o l i s œ ʁ	p o l i s ø z
p o l i s õ	p o l i s ɔ n
p o l i t i s j ɛ̃	p o l i t i s j ɛ n
p o l y œ ʁ	p o l y ø z
p o l i t e k n i s j ɛ̃	p o l i t e k n i s j ɛ n
p õ d œ ʁ	p õ d ø z
p o ʁ ʃ e	p o ʁ ʃ ɛ ʁ
p o ʁ t œ ʁ	p o ʁ t ø z
p o ʁ t j e	p o ʁ t j ɛ ʁ
p o ʁ t o ʁ i k ɛ̃	p o ʁ t o ʁ i k ɛ n
p o z œ ʁ	p o z ø z
p o s e d e	p o s e d e
p o s t j e	p o s t j ɛ ʁ
p o s t y l ã	p o s t y l ã t
p o t j e	p o t j ɛ ʁ
p u l ɛ̃	p u l ɛ n
p u ʁ s ɥ i v ã	p u ʁ s ɥ i v ã t
p u ʁ v w a j œ ʁ	p u ʁ v w a j ø z
p o ɛ t	p o ɛ t ɛ s
p ʁ a t i s j ɛ̃	p ʁ a t i s j ɛ n
p ʁ a t i k ã	p ʁ a t i k ã t
p ʁ ə m j e	p ʁ ə m j ɛ ʁ
p ʁ ə n œ ʁ	p ʁ ə n ø z
p ʁ e s b i t e ʁ j ɛ̃	p ʁ e s b i t e ʁ j ɛ n
p ʁ e s e	p ʁ e s e
p ʁ e s t i d i ʒ i t a t œ ʁ	p ʁ e s t i d i ʒ i t a t ʁ i s
p ʁ i j œ ʁ	p ʁ i j œ ʁ
p ʁ i m i t i f	p ʁ i m i t i v
p ʁ ɛ̃ s	p ʁ ɛ̃ s ɛ s
p ʁ ɛ̃ s i p a l	p ʁ ɛ̃ s i p a l
p ʁ i z o n j e	p ʁ i z o n j ɛ ʁ
p ʁ i v i l e ʒ j e	p ʁ i v i l e ʒ j e
p ʁ o ʃ ɛ̃	p ʁ o ʃ ɛ n
p ʁ o k y ʁ a t œ ʁ	p ʁ o k y ʁ a t ʁ i s
p ʁ o k y ʁ œ ʁ	p ʁ o k y ʁ ø z
p ʁ o d y k t œ ʁ	p ʁ o d y k t ʁ i s
p ʁ o f e s j o n ɛ l	p ʁ o f e s j o n ɛ l
p ʁ o f i l œ ʁ	p ʁ o f i l ø z
p ʁ o f i t œ ʁ	p ʁ o f i t ø z
p ʁ o ɡ ʁ a m a t œ ʁ	p ʁ o ɡ ʁ a m a t ʁ i s
p ʁ o ɡ ʁ a m œ ʁ	p ʁ o ɡ ʁ a m ø z
p ʁ o m n œ ʁ	p ʁ o m n ø z
p ʁ o m e t œ ʁ	p ʁ o m e t ø z
p ʁ o m o t œ ʁ	p ʁ o m o t ʁ i s
p ʁ o f ɛ t	p ʁ o f ɛ t ɛ s
p ʁ o s k ʁ i	p ʁ o s k ʁ i t
p ʁ o s t i t ɥ e	p ʁ o s t i t ɥ e
p ʁ o t e k t œ ʁ	p ʁ o t e k t ʁ i s
p ʁ o t e s t ã	p ʁ o t e s t ã t
p ʁ o t e ʒ e	p ʁ o t e ʒ e
p ʁ o v o k a t œ ʁ	p ʁ o v o k a t ʁ i s
p ʁ y s j ɛ̃	p ʁ y s j ɛ n
p ʁ e s e p t œ ʁ	p ʁ e s e p t ʁ i s
p ʁ e s e d ã	p ʁ e s e d ã t
p ʁ e d e s t i n e	p ʁ e d e s t i n e
p ʁ e f e ʁ e	p ʁ e f e ʁ e
p ʁ e m a t y ʁ e	p ʁ e m a t y ʁ e
p ʁ e n o m e	p ʁ e n o m e
p ʁ e p a ʁ a t œ ʁ	p ʁ e p a ʁ a t ʁ i s
p ʁ e p o z e	p ʁ e p o z e
p ʁ e z ã t a t œ ʁ	p ʁ e z ã t a t ʁ i s
p ʁ e z i d ã	p ʁ e z i d ã t
p ʁ e t ã d ã	p ʁ e t ã d ã t
p ʁ e t ã s j a ʁ	p ʁ e t ã s j a ʁ d
p ʁ e v n y	p ʁ e v n y
p ʁ e ʃ œ ʁ	p ʁ e ʃ ø z
p ʁ e t œ ʁ	p ʁ e t ø z
p ʁ ɛ t ʁ	p ʁ ɛ t ʁ ɛ s
p y s o	p y s ɛ l
p y ʁ i t ɛ̃	p y ʁ i t ɛ n
p a t i s j e	p a t i s j ɛ ʁ
p e l ʁ ɛ̃	p e l ʁ i n
p e ʃ œ ʁ	p e ʃ ʁ ɛ s
p e d ã	p e d ã t
p e n i t ã	p e n i t ã t
p e k n o	p e k n o d
p e t a ʁ d j e	p e t a ʁ d j ɛ ʁ
p e ʃ œ ʁ	p e ʃ ø z
k e s t j o n œ ʁ	k e s t j o n ø z
k ɛ̃ k a j e	k ɛ̃ k a j ɛ ʁ
k e m ã d œ ʁ	k e m ã d ø z
k e t œ ʁ	k e t ø z
ʁ a b a t œ ʁ	ʁ a b a t ø z
ʁ a k l œ ʁ	ʁ a k l ø z
ʁ a k o l œ ʁ	ʁ a k o l ø z
ʁ a k õ t œ ʁ	ʁ a k õ t ø z
ʁ a d i k a l	ʁ a d i k a l
ʁ a d ɛ̃	ʁ a d i n
ʁ e z o n œ ʁ	ʁ e z o n ø z
ʁ a m a s œ ʁ	ʁ a m a s ø z
ʁ ã k y n j e	ʁ ã k y n j ɛ ʁ
ʁ ã d o n œ ʁ	ʁ ã d o n ø z
ʁ a p œ ʁ	ʁ a p ø z
ʁ a p o ʁ t œ ʁ	ʁ a p o ʁ t ø z
ʁ a z œ ʁ	ʁ a z ø z
ʁ a t e	ʁ a t e
ʁ a v a ʒ œ ʁ	ʁ a v a ʒ ø z
ʁ a v i s œ ʁ	ʁ a v i s ø z
ʁ a v i t a j œ ʁ	ʁ a v i t a j ø z
ʁ e j õ	ʁ e j ɔ n
ʁ ə s l œ ʁ	ʁ ə s l ø z
ʁ ə s v œ ʁ	ʁ ə s v ø z
ʁ ə d ʁ e s œ ʁ	ʁ ə d ʁ e s ø z
ʁ ə f u l e	ʁ ə f u l e
ʁ ə f y z e	ʁ ə f y z e
ʁ ə l e ɡ e	ʁ ə l e ɡ e
ʁ ã p l a s ã	ʁ ã p l a s ã t
ʁ ə n a ʁ	ʁ ə n a ʁ d
ʁ ã f e ʁ m e	ʁ ã f e ʁ m e
ʁ ã t j e	ʁ ã t j ɛ ʁ
ʁ ə n e ɡ a	ʁ ə n e ɡ a t
ʁ ə p a s œ ʁ	ʁ ə p a s ø z
ʁ ə p ã t ã	ʁ ə p ã t ã t
ʁ ə p ã t i	ʁ ə p ã t i
ʁ ə p ʁ o d y k t œ ʁ	ʁ ə p ʁ o d y k t ʁ i s
ʁ ə p ʁ e z ã t ã	ʁ ə p ʁ e z ã t ã t
ʁ ə k e ʁ ã	ʁ ə k e ʁ ã t
ʁ e s k a p e	ʁ e s k a p e
ʁ e s k i j œ ʁ	ʁ e s k i j ø z
ʁ ə s o ʁ t i s ã	ʁ ə s o ʁ t i s ã t
ʁ e s t o ʁ a t œ ʁ	ʁ e s t o ʁ a t ʁ i s
ʁ ə t a ʁ d e	ʁ ə t a ʁ d e
ʁ ə t ʁ e t e	ʁ ə t ʁ e t e
ʁ ə v ã ʃ a ʁ	ʁ ə v ã ʃ a ʁ d
ʁ ə v ã d œ ʁ	ʁ ə v ã d ø z
ʁ i b o	ʁ i b ɔ t
ʁ i ʃ a ʁ	ʁ i ʃ a ʁ d
ʁ i d o	ʁ i d ɛ l
ʁ j œ ʁ	ʁ j ø z
ʁ i ɡ o l a ʁ	ʁ i ɡ o l a ʁ d
ʁ i m œ ʁ	ʁ i m ø z
ʁ ɛ̃ ɡ a ʁ	ʁ ɛ̃ ɡ a ʁ d
ʁ i t a l	ʁ i t a l
ʁ i v a l	ʁ i v a l
ʁ o k œ ʁ	ʁ o k ø z
ʁ o m ɛ̃	ʁ o m ɛ n
ʁ o m ã s j e	ʁ o m ã s j ɛ ʁ
ʁ o m a n i ʃ ɛ l	ʁ o m a n i ʃ ɛ l
ʁ õ ʃ õ	ʁ õ ʃ ɔ n
ʁ õ ʃ o n œ ʁ	ʁ õ ʃ o n ø z
ʁ õ f l œ ʁ	ʁ õ f l ø z
ʁ o t œ ʁ	ʁ o t ø z
ʁ o t y ʁ j e	ʁ o t y ʁ j ɛ ʁ
ʁ u b l a ʁ	ʁ u b l a ʁ d
ʁ u ʒ o	ʁ u ʒ o d
ʁ u m ɛ̃	ʁ u m ɛ n
ʁ u k ɛ̃	ʁ u k i n
ʁ u t j e	ʁ u t j ɛ ʁ
ʁ y ʃ e	ʁ y ʃ e
ʁ y ʁ a l	ʁ y ʁ a l
ʁ y z e	ʁ y z e
ʁ a l œ ʁ	ʁ a l ø z
ʁ e a l i z a t œ ʁ	ʁ e a l i z a t ʁ i s
ʁ e s i t ã	ʁ e s i t ã t
ʁ e k y p	ʁ e k y p
ʁ e d a k t œ ʁ	ʁ e d a k t ʁ i s
ʁ e d ã p t œ ʁ	ʁ e d ã p t ʁ i s
ʁ e f y ʒ j e	ʁ e f y ʒ j e
ʁ e ʒ ã	ʁ e ʒ ã t
ʁ e ʒ j o n a l	ʁ e ʒ j o n a l
ʁ e ʒ i s œ ʁ	ʁ e ʒ i s ø z
ʁ e ɡ y l j e	ʁ e ɡ y l j ɛ ʁ
ʁ e p a ʁ a t œ ʁ	ʁ e p a ʁ a t ʁ i s
ʁ e p y b l i k ɛ̃	ʁ e p y b l i k ɛ n
ʁ e p e t i t œ ʁ	ʁ e p e t i t ʁ i s
ʁ e z i d ã	ʁ e z i d ã t
ʁ e z i ɲ e	ʁ e z i ɲ e
ʁ e z i s t ã	ʁ e z i s t ã t
ʁ e v o l t e	ʁ e v o l t e
ʁ e v œ ʁ	ʁ e v ø z
ʁ o d œ ʁ	ʁ o d ø z
ʁ o t i s œ ʁ	ʁ o t i s ø z
s a b o t œ ʁ	s a b o t ø z
s a k ʁ i f j e	s a k ʁ i f j e
s a k ʁ i s t ɛ̃	s a k ʁ i s t ɛ n
s a a ʁ j ɛ̃	s a a ʁ j ɛ n
s e z o n j e	s e z o n j ɛ ʁ
s a l a ʁ j e	s a l a ʁ j e
s a ʁ a z ɛ̃	s a ʁ a z i n
s o t œ ʁ	s o t ø z
s o v a ʒ õ	s o v a ʒ ɔ n
s o v a ʒ ɛ̃	s o v a ʒ i n
s o v œ ʁ	s o v ø z
s a v ã	s a v ã t
s a v w a j a ʁ	s a v w a j a ʁ d
s k u t	s k u t
s k y l t œ ʁ	s k y l t ʁ i s
s e l e ʁ a	s e l e ʁ a t
s ã t i m ã t a l	s ã t i m ã t a l
s ə ʁ ɛ̃	s ə ʁ ɛ n
s ə ʁ ɛ̃	s ə ʁ i n
s e ʁ p ã t ɛ̃	s e ʁ p ã t i n
s e ʁ y ʁ j e	s e ʁ y ʁ j ɛ ʁ
s e ʁ v ã	s e ʁ v ã t
s e ʁ v œ ʁ	s e ʁ v ø z
s œ l	s œ l
ʃ e k s p i ʁ j ɛ̃	ʃ e k s p i ʁ j ɛ n
ʃ ã p w i n œ ʁ	ʃ ã p w i n ø z
s i s i l j ɛ̃	s i s i l j ɛ n
s i m y l a t œ ʁ	s i m y l a t ʁ i s
s k j œ ʁ	s k j ø z
s n o b i n a ʁ	s n o b i n a ʁ d
s w a f a ʁ	s w a f a ʁ d
s w a ɲ ã	s w a ɲ ã t
s o l d a	s o l d a t
s o l i s i t œ ʁ	s o l i s i t ø z
s õ d œ ʁ	s õ d ø z
s õ d e	s õ d e
s o ʁ s j e	s o ʁ s j ɛ ʁ
s o	s ɔ t
s u d œ ʁ	s u d ø z
s u f l ã	s u f l ã t
s u f l œ ʁ	s u f l ø z
s u d i ʁ e k t œ ʁ	s u d i ʁ e k t ʁ i s
s u v ʁ ɛ̃	s u v ʁ ɛ n
s u l a ʁ	s u l a ʁ d
s p e k t a t œ ʁ	s p e k t a t ʁ i s
s p o ʁ t i f	s p o ʁ t i v
s p e k y l a t œ ʁ	s p e k y l a t ʁ i s
s t a t i s t i s j ɛ̃	s t a t i s t i s j ɛ n
s t o p œ ʁ	s t o p ø z
s t ʁ i p t i z œ ʁ	s t ʁ i p t i z ø z
s y s œ ʁ	s y s ø z
s y k ʁ i j e	s y k ʁ i j ɛ ʁ
s y d a f ʁ i k ɛ̃	s y d a f ʁ i k ɛ n
s y d a m e ʁ i k ɛ̃	s y d a m e ʁ i k ɛ n
s ɥ i s i d e	s ɥ i s i d e
s ɥ i v ã	s ɥ i v ã t
s ɥ i v œ ʁ	s ɥ i v ø z
s y p l i s j e	s y p l i s j e
s y p l e ã	s y p l e ã t
s y p o ʁ t œ ʁ	s y p o ʁ t ʁ i s
s y p e ʁ j œ ʁ	s y p e ʁ j œ ʁ
s y ʁ d w e	s y ʁ d w e
s œ ʁ f œ ʁ	s œ ʁ f ø z
s y ʁ ɛ̃ t ã d ã	s y ʁ ɛ̃ t ã d ã t
s y ʁ v e j ã	s y ʁ v e j ã t
s y ʁ v i v ã	s y ʁ v i v ã t
s y s d i	s y s d i t
s y z ʁ ɛ̃	s y z ʁ ɛ n
s ɛ̃ p a t i z ã	s ɛ̃ p a t i z ã t
s i ʁ j ɛ̃	s i ʁ j ɛ n
s e d y k t œ ʁ	s e d y k t ʁ i s
s e n a t œ ʁ	s e n a t ʁ i s
s e v i l ã	s e v i l a n
t a k t i s j ɛ̃	t a k t i s j ɛ n
t a i s j ɛ̃	t a i s j ɛ n
t a p i s j e	t a p i s j ɛ ʁ
t a ʁ t ã	t a ʁ t a n
t a t i j õ	t a t i j ɔ n
t a t w œ ʁ	t a t w ø z
t o l a ʁ	t o l a ʁ d
t o l j e	t o l j ɛ ʁ
t e k n i s j ɛ̃	t e k n i s j ɛ n
t ɛ̃ t y ʁ j e	t ɛ̃ t y ʁ j ɛ ʁ
t ə n ã s j e	t ə n ã s j ɛ ʁ
t ã t a t œ ʁ	t ã t a t ʁ i s
t e ʁ m i n a l	t e ʁ m i n a l
t e ʁ j ɛ̃	t e ʁ j ɛ n
t e s t œ ʁ	t e s t ø z
t e k s ã	t e k s a n
t e o ʁ i s j ɛ̃	t e o ʁ i s j ɛ n
t i ɡ ʁ	t i ɡ ʁ ɛ s
t i ʁ œ ʁ	t i ʁ ø z
t i s ʁ ã	t i s ʁ ã d
t i s œ ʁ	t i s ø z
t õ b œ ʁ	t õ b ø z
t õ d œ ʁ	t õ d ø z
t u l u z ɛ̃	t u l u z ɛ n
t u ʁ t ə ʁ o	t u ʁ t ə ʁ ɛ l
t ʁ a d y k t œ ʁ	t ʁ a d y k t ʁ i s
t ʁ a f i k ã	t ʁ a f i k ã t
t ʁ a ʒ e d j ɛ̃	t ʁ a ʒ e d j ɛ n
t ʁ ã ʃ œ ʁ	t ʁ ã ʃ ø z
t ʁ ã s p o ʁ t e	t ʁ ã s p o ʁ t e
t ʁ a k œ ʁ	t ʁ a k ø z
t ʁ a v a j œ ʁ	t ʁ a v a j ø z
t ʁ e n a ʁ	t ʁ e n a ʁ d
t ʁ i ʃ œ ʁ	t ʁ i ʃ ø z
t ʁ i k o t œ ʁ	t ʁ i k o t ø z
t ʁ i j œ ʁ	t ʁ i j ø z
t ʁ i j õ f a t œ ʁ	t ʁ i j õ f a t ʁ i s
t ʁ i p j e	t ʁ i p j ɛ ʁ
t ʁ i p o t œ ʁ	t ʁ i p o t ø z
t ʁ i z a j œ l	t ʁ i z a j œ l
t ʁ o t œ ʁ	t ʁ o t ø z
t ʁ u j a ʁ	t ʁ u j a ʁ d
t ʁ y ã	t ʁ y ã d
t ʁ y k œ ʁ	t ʁ y k ø z
t ʁ e p a n e	t ʁ e p a n e
t ʁ e p a s e	t ʁ e p a s e
t ʁ e z o ʁ j e	t ʁ e z o ʁ j ɛ ʁ
t y ʁ k	t y ʁ k
t y t œ ʁ	t y t ʁ i s
t ɥ e	t ɥ e
t e l e s p e k t a t œ ʁ	t e l e s p e k t a t ʁ i s
t o l j e	t o l j ɛ ʁ
y k ʁ e n j ɛ̃	y k ʁ e n j ɛ n
y z y ʁ j e	y z y ʁ j ɛ ʁ
y z y ʁ p a t œ ʁ	y z y ʁ p a t ʁ i s
y t i l i z a t œ ʁ	y t i l i z a t ʁ i s
v a k ã s j e	v a k ã s j ɛ ʁ
v a d ʁ u j œ ʁ	v a d ʁ u j ø z
v a ɡ a b õ	v a ɡ a b õ d
v ɛ̃ k y	v ɛ̃ k y
v a l ã s j ɛ̃	v a l ã s j ɛ n
v a l ã t ɛ̃	v a l ã t i n
v a l s œ ʁ	v a l s ø z
v ã t a ʁ	v ã t a ʁ d
v a s a l	v a s a l
v o ʁ j ɛ̃	v o ʁ j ɛ n
v e n a ʁ	v e n a ʁ d
v ã d œ ʁ	v ã d ø z
v ã d y	v ã d y
v ã ʒ œ ʁ	v ã ʒ ʁ ɛ s
v œ f	v œ v
v i s p ʁ e z i d ã	v i s p ʁ e z i d ã t
v i k õ t	v i k õ t ɛ s
v j e j a ʁ	v j e j a ʁ d
v i ɲ ə ʁ õ	v i ɲ ə ʁ ɔ n
v i z i t œ ʁ	v i z i t ø z
v i t i k y l t œ ʁ	v i t i k y l t ʁ i s
v i v ã d j e	v i v ã d j ɛ ʁ
v w a z ɛ̃	v w a z i n
v o l œ ʁ	v o l ø z
v w a j a ʒ œ ʁ	v w a j a ʒ ø z
v w a j ã	v w a j ã t
v w a j œ ʁ	v w a j ø z
v w a j u	v w a j u t
v e ʒ e t a l j ɛ̃	v e ʒ e t a l j ɛ n
v e ʁ i f i k a t œ ʁ	v e ʁ i f i k a t ʁ i s
j u p ɛ̃	j u p i n
z o n a ʁ	z o n a ʁ d
z e l a t œ ʁ	z e l a t ʁ i s
e k a j e	e k a j ɛ ʁ
e s e ʁ v ə l e	e s e ʁ v ə l e
e k o t j e	e k o t j ɛ ʁ
e k l e ʁ œ ʁ	e k l e ʁ ø z
e k l o p e	e k l o p e
e k o l j e	e k o l j ɛ ʁ
e k o ʁ ʃ e	e k o ʁ ʃ e
e k u t œ ʁ	e k u t ø z
e k ʁ i v ɛ̃	e k ʁ i v ɛ n
e k ɥ i j e	e k ɥ i j ɛ ʁ
e d ã t e	e d ã t e
e d i t œ ʁ	e d i t ʁ i s
e d y k a t œ ʁ	e d y k a t ʁ i s
e ʒ i p s j ɛ̃	e ʒ i p s j ɛ n
e l e k t œ ʁ	e l e k t ʁ i s
e l e k t ʁ i s j ɛ̃	e l e k t ʁ i s j ɛ n
e l v œ ʁ	e l v ø z
e l e ɡ ã	e l e ɡ ã t
e l e f ã	e l e f ã t
e m i ɡ ʁ ã	e m i ɡ ʁ ã t
e m i ɡ ʁ e	e m i ɡ ʁ e
e m i l j ɛ̃	e m i l j ɛ n
e o l j ɛ̃	e o l j ɛ n
e p a ɲ œ l	e p a ɲ œ l
e p i s j e	e p i s j ɛ ʁ
e p i s k o p a l j ɛ̃	e p i s k o p a l j ɛ n
e p i s t o l j e	e p i s t o l j ɛ ʁ
e k i p j e	e k i p j ɛ ʁ
e ʁ y d i	e ʁ y d i t
e t e ʁ n ɛ l	e t e ʁ n ɛ l
e t u ʁ d i	e t u ʁ d i
e t ʁ ã ʒ e	e t ʁ ã ʒ ɛ ʁ
e t ʁ ã ɡ l œ ʁ	e t ʁ ã ɡ l ø z
e t y d j ã	e t y d j ã t
e v a k ɥ e	e v a k ɥ e
e v a d e	e v a d e
e v o l ɥ e	e v o l ɥ e