sh o v	sh v a
lj e v	lj v a
r o v	r v a
a b a zj i nj e ts	a b a zj i n ts a
a bj i s sj i nj e ts	a bj i s sj i n ts a
a b x a zj e ts	a b x a z ts a
a v a rj e ts	a v a r ts a
a v g u s tj i nj e ts	a v g u s tj i n ts a
a vj i a n o sj e ts	a vj i a n o s ts a
a v s t r a lj i j e ts	a v s t r a lj i j ts a
a v s t rj i j e ts	a v s t rj i j ts a
a v t o z a v o dj e ts	a v t o z a v o d ts a
a v t o k r u zh o k	a v t o k r u zh k a
a g nj e ts	a g n ts a
a d zh a rj e ts	a d zh a r ts a
a d rj e s o k	a d rj e s k a
a d rj e s o ch e k	a d rj e s o ch k a
a d i gj e j e ts	a d i gj e j ts a
a zj e r b a j d zh a nj e ts	a zj e r b a j d zh a n ts a
a l b a nj e ts	a l b a n ts a
a lj e k s a n d rj i j e ts	a lj e k s a n d rj i j ts a
a l zh i rj e ts	a l zh i r ts a
a l m a a tj i nj e ts	a l m a a tj i n ts a
a l t a j e ts	a l t a j ts a
a lj bj i g o j e ts	a lj bj i g o j ts a
a lj u t o rj e ts	a lj u t o r ts a
a mj e rj i k a nj e ts	a mj e rj i k a n ts a
a n gj e l o k	a n gj e l k a
a n gj e l o ch e k	a n gj e l o ch k a
a n g lj i k a nj e ts	a n g lj i k a n ts a
a n dj i j e ts	a n dj i j ts a
a nj e k d o tj e ts	a nj e k d o t ts a
a n kj e r o k	a n kj e r k a
a n n a mj e ts	a n n a m ts a
a r a mj e j e ts	a r a mj e j ts a
a r gj e n tj i nj e ts	a r gj e n tj i n ts a
a r zh a nj e ts	a r zh a n ts a
a rj i j e ts	a rj i j ts a
a r mj e j e ts	a r mj e j ts a
a r mj a ch o k	a r mj a ch k a
a r x a r o vj e ts	a r x a r o v ts a
a r ch i nj e ts	a r ch i n ts a
a s sj i rj i j e ts	a s sj i rj i j ts a
a t a m a nj e ts	a t a m a n ts a
a t a m a n o vj e ts	a t a m a n o v ts a
a f g a nj e ts	a f g a n ts a
a f rj i k a nj e ts	a f rj i k a n ts a
a xj e j e ts	a xj e j ts a
a x tj e r sh tj e vj e nj	a x tj e r sh tj e v nj a
b a v a rj e ts	b a v a r ts a
b a g o r	b a g r a
b a g rj a nj e ts	b a g rj a n ts a
b a kj i nj e ts	b a kj i n ts a
b a l k a rj e ts	b a l k a r ts a
b a l o vj e nj	b a l o v nj a
b a l tj i j e ts	b a l tj i j ts a
b a n ch o k	b a n ch k a
b a r a nj e ts	b a r a n ts a
b a r a n o k	b a r a n k a
b a r a sh e k	b a r a sh k a
b a r a sh e k	b a r a sh k a
b a r vj i n o k	b a r vj i n k a
b a s n o pj i sj e ts	b a s n o pj i s ts a
b a s o k	b a s k a
b a t a rj e j e ts	b a t a rj e j ts a
b a t o zh o k	b a t o zh k a
b a ch o k	b a ch k a
b a sh l i ch o k	b a sh l i ch k a
b a sh m a ch o k	b a sh m a ch k a
bj e g u n o k	bj e g u n k a
bj e g u n o k	bj e g u n k a
bj e zh e nj e ts	bj e zh e n ts a
bj e z m a t o k	bj e z m a t k a
bj e z u mj e ts	bj e z u m ts a
bj e lj o k	bj e lj k a
bj e lj e ts	bj e lj ts a
bj e l o g v a r dj e j e ts	bj e l o g v a r dj e j ts a
bj e l o dj e rj e vj e ts	bj e l o dj e rj e v ts a
bj e l o k	bj e l k a
bj e lj gj i j e ts	bj e lj gj i j ts a
bj e n g a lj e ts	bj e n g a lj ts a
bj e nj e dj i k tj i nj e ts	bj e nj e dj i k tj i n ts a
bj e r k o vj e ts	bj e r k o v ts a
bj e r lj i nj e ts	bj e r lj i n ts a
bj e r n a r dj i nj e ts	bj e r n a r dj i n ts a
bj e s p o p o vj e ts	bj e s p o p o v ts a
bj e s ts e n o k	bj e s ts e n k a
bj i vj e nj	bj i v nj a
bj i r m a nj e ts	bj i r m a n ts a
bj i t o k	bj i t k a
bj i t o ch e k	bj i t o ch k a
b lj i n o k	b lj i n k a
b o bj o r	b o b r a
b o bj o r	b o b r a
b o b o k	b o b k a
b o g o b o rj e ts	b o g o b o r ts a
b o g o m o lj e ts	b o g o m o lj ts a
b o g o n o sj e ts	b o g o n o s ts a
b o d rj a ch o k	b o d rj a ch k a
b o j o k	b o j k a
b o j e ts	b o j ts a
b o zh o k	b o zh k a
b o lj i vj i j e ts	b o lj i vj i j ts a
b o rj e ts	b o r ts a
b o rj e ts	b o r ts a
b o r z o pj i sj e ts	b o r z o pj i s ts a
b o r o vj i ch o k	b o r o vj i ch k a
b o r o v o k	b o r o v k a
b o r o v o k	b o r o v k a
b o r shshj o k	b o r shshj k a
b o ch a zh o k	b o ch a zh k a
b o ch o n o k	b o ch o n k a
b o ch o n o ch e k	b o ch o n o ch k a
b r a zj i lj e ts	b r a zj i lj ts a
b r a tj e ts	b r a t ts a
b r a t o k	b r a t k a
b r a ch o k	b r a ch k a
b rj e dj e nj	b rj e d nj a
b rj e z g lj i vj e ts	b rj e z g lj i v ts a
b rj e l o ch e k	b rj e l o ch k a
b rj e t o nj e ts	b rj e t o n ts a
b rj i g a d mj i lj e ts	b rj i g a d mj i lj ts a
b rj i t a nj e ts	b rj i t a n ts a
b r o nj e n o sj e ts	b r o nj e n o s ts a
b r o nj e n o sj e ts	b r o nj e n o s ts a
b r o s o k	b r o s k a
b r u s o k	b r u s k a
b r u s o ch e k	b r u s o ch k a
b rj u z g lj i vj e ts	b rj u z g lj i v ts a
b u bj e n	b u b n a
b u bj e nj e ts	b u bj e n ts a
b u g o r	b u g r a
b u g o r o k	b u g o r k a
b u g o r o ch e k	b u g o r o ch k a
b u j o k	b u j k a
b u k o vj i nj e ts	b u k o vj i n ts a
b u n d o vj e ts	b u n d o v ts a
b u r a ch o k	b u r a ch k a
b u x a rj e ts	b u x a r ts a
b i ch o k	b i ch k a
v a lj o k	v a lj k a
v a lj e ts	v a lj ts a
v a l o k	v a l k a
v a rj e nj e ts	v a rj e n ts a
v a sj i lj o k	v a sj i lj k a
v d o vj e ts	v d o v ts a
vj e gj e t a rj i a nj e ts	vj e gj e t a rj i a n ts a
vj e j e r o k	vj e j e r k a
vj e lj i k o b rj i t a nj e ts	vj e lj i k o b rj i t a n ts a
vj e n gj e rj e ts	vj e n gj e r ts a
vj e nj e s u e lj e ts	vj e nj e s u e lj ts a
vj e nj e ts	vj e n ts a
vj e nj e ts	vj e n ts a
vj e nj e ts i a nj e ts	vj e nj e ts i a n ts a
vj e n zj e lj o k	vj e n zj e lj k a
vj e nj i ch e k	vj e nj i ch k a
vj e n o k	vj e n k a
vj e n o ch e k	vj e n o ch k a
vj e n ts e n o sj e ts	vj e n ts e n o s ts a
vj e r s t a ch o k	vj e r s t a ch k a
vj e r t lj u zh o k	vj e r t lj u zh k a
vj e r sh o k	vj e r sh k a
vj e tj e r o k	vj e tj e r k a
vj e x o vj e ts	vj e x o v ts a
vj e ch e r o k	vj e ch e r k a
vj e shshj mj e sh o k	vj e shshj mj e sh k a
v z g o r o k	v z g o r k a
v z l o b o k	v z l o b k a
v zj a t o k	v zj a t k a
vj i z a n tj i j e ts	vj i z a n tj i j ts a
vj i l o k	vj i l k a
vj i n o t o r g o vj e ts	vj i n o t o r g o v ts a
vj i s o k	vj i s k a
vj i s o ch e k	vj i s o ch k a
vj i t o k	vj i t k a
vj i t o ch e k	vj i t o ch k a
vj i tj u tj e nj	vj i tj u t nj a
vj i x o r	vj i x r a
vj i x o r o k	vj i x o r k a
vj i x o rj	vj i x rj a
v l a dj e lj e ts	v l a dj e lj ts a
v l a s t o lj u bj e ts	v l a s t o lj u b ts a
v n u ch e k	v n u ch k a
v n u ch o k	v n u ch k a
v o z o k	v o z k a
v o l o sj e nj e ts	v o l o sj e n ts a
v o l o s o k	v o l o s k a
v o l ch e ts	v o l ch ts a
v o l ch o k	v o l ch k a
v o lj n o d u mj e ts	v o lj n o d u m ts a
v o lj tj e rj j a nj e ts	v o lj tj e rj j a n ts a
v o r o bj e j	v o r o bj j a
v o r o b u sh e k	v o r o b u sh k a
v o r o b i sh e k	v o r o b i sh k a
v o r o nj e ts	v o r o n ts a
v o r o t nj i ch o k	v o r o t nj i ch k a
v o r o t o k	v o r o t k a
v o r o sh o k	v o r o sh k a
v r a n gj e lj e vj e ts	v r a n gj e lj e v ts a
v r u b o k	v r u b k a
v sj e vj i dj e ts	v sj e vj i d ts a
v sj e p r o shshj e nj e ts	v sj e p r o shshj e n ts a
v t u z o vj e ts	v t u z o v ts a
v u z o vj e ts	v u z o v ts a
v sh i vj e ts	v sh i v ts a
v sh i v o k	v sh i v k a
v i b o r z o k	v i b o r z k a
v i vj e dj e nj e ts	v i vj e dj e n ts a
v i v o d o k	v i v o d k a
v i d vj i zh e nj e ts	v i d vj i zh e n ts a
v i k o r m o k	v i k o r m k a
v i m i sj e l	v i m i s l a
v i p l a v o k	v i p l a v k a
v i p l i v o k	v i p l i v k a
v i p o l zj e nj	v i p o l z nj a
v i p o l z o k	v i p o l z k a
v i p o l z o k	v i p o l z k a
v i p o r o k	v i p o r k a
v i p o r o t o k	v i p o r o t k a
v i r a b o t o k	v i r a b o t k a
v i r o d o k	v i r o d k a
v i r o zh dj e nj e ts	v i r o zh dj e n ts a
v i r o s t o k	v i r o s t k a
v i r o s t o k	v i r o s t k a
v i r u b o k	v i r u b k a
v i s a d o k	v i s a d k a
v i sj e lj e nj e ts	v i sj e lj e n ts a
v i sj e l o k	v i sj e l k a
v i s o t o pj i sj e ts	v i s o t o pj i s ts a
v i x o dj e ts	v i x o d ts a
vj j e t n a mj e ts	vj j e t n a m ts a
vj j u n o k	vj j u n k a
vj j u n o ch e k	vj j u n o ch k a
vj j u r o k	vj j u r k a
g a v a j e ts	g a v a j ts a
g a lj i sj i j e ts	g a lj i sj i j ts a
g a nj e ts	g a n ts a
g a rj i b a lj dj i j e ts	g a rj i b a lj dj i j ts a
g a r nj e ts	g a r n ts a
g v a r dj e j e ts	g v a r dj e j ts a
g v a tj e m a lj e ts	g v a tj e m a lj ts a
g vj i nj e j e ts	g vj i nj e j ts a
g v o z d o k	g v o z d k a
gj e gj e lj j a nj e ts	gj e gj e lj j a n ts a
gj e n u e zj e ts	gj e n u e z ts a
gj e r m a nj e ts	gj e r m a n ts a
gj e s t a p o vj e ts	gj e s t a p o v ts a
gj i d r o u zj e l	gj i d r o u z l a
gj i pj e r b o rj e j e ts	gj i pj e r b o rj e j ts a
gj i t lj e r o vj e ts	gj i t lj e r o v ts a
g l a z o k	g l a z k a
g l a z o ch e k	g l a z o ch k a
g l o t o k	g l o t k a
g l o t o ch e k	g l o t o ch k a
g l u pj e ts	g l u p ts a
g lj a nj e ts	g lj a n ts a
g nj i lj e ts	g nj i lj ts a
g n o j nj i ch o k	g n o j nj i ch k a
g o v o r o k	g o v o r k a
g o d o vj i ch o k	g o d o vj i ch k a
g o d o k	g o d k a
g o d o ch e k	g o d o ch k a
g o l bj e ts	g o l b ts a
g o lj e ts	g o lj ts a
g o lj e ts	g o lj ts a
g o l l a n dj e ts	g o l l a n d ts a
g o l o d r a nj e ts	g o l o d r a n ts a
g o l o sj o n o k	g o l o sj o n k a
g o l o s o k	g o l o s k a
g o l o s o ch e k	g o l o s o ch k a
g o l u bj e ts	g o l u b ts a
g o l u b o k	g o l u b k a
g o l u b o ch e k	g o l u b o ch k a
g o mj i n d a n o vj e ts	g o mj i n d a n o v ts a
g o nj e ts	g o n ts a
g o r b o k	g o r b k a
g o r b u n o k	g o r b u n k a
g o r dj e lj i vj e ts	g o r dj e lj i v ts a
g o rj e ts	g o r ts a
g o r k o m o vj e ts	g o r k o m o v ts a
g o r o d o k	g o r o d k a
g o r sh o k	g o r sh k a
g o r sh o ch e k	g o r sh o ch k a
g o rj k o vj e ts	g o rj k o v ts a
g o s z a j o m	g o s z a j m a
g o s tj i nj e ts	g o s tj i n ts a
g o s tj i n o d v o rj e ts	g o s tj i n o d v o r ts a
g rj e bj e nj	g rj e b nj a
g rj e bj e ts	g rj e b ts a
g rj e bj e sh o k	g rj e bj e sh k a
g rj e bj e sh o k	g rj e bj e sh k a
g rj e b o k	g rj e b k a
g rj e n l a n dj e ts	g rj e n l a n d ts a
g rj e n o k	g rj e n k a
g rj e sh o k	g rj e sh k a
g rj i b o k	g rj i b k a
g rj i b o ch e k	g rj i b o ch k a
g rj i vj e n nj i ch e k	g rj i vj e n nj i ch k a
g r o m o vj e r zh e ts	g r o m o vj e r zh ts a
g r o x o t o k	g r o x o t k a
g r u z d o k	g r u z d k a
g r u z o vj i ch o k	g r u z o vj i ch k a
g r u z o v l a dj e lj e ts	g r u z o v l a dj e lj ts a
g u d o k	g u d k a
g u rj i j e ts	g u rj i j ts a
g u sj o k	g u sj k a
g u sj o k	g u sj k a
d a v a lj e ts	d a v a lj ts a
d a gj e s t a nj e ts	d a gj e s t a n ts a
d a l m a tj i nj e ts	d a l m a tj i n ts a
d a n a j e ts	d a n a j ts a
d a r gj i nj e ts	d a r gj i n ts a
d a ch e v l a dj e lj e ts	d a ch e v l a dj e lj ts a
d vj i zh e nj e ts	d vj i zh e n ts a
d vj i zh o k	d vj i zh k a
d v o j e b o rj e ts	d v o j e b o r ts a
d v o j e vj e rj e ts	d v o j e vj e r ts a
d v o j e zh e nj e ts	d v o j e zh e n ts a
d v o rj e ts	d v o r ts a
d v u g o d o k	d v u g o d k a
d v u z u bj e ts	d v u z u b ts a
d v u nj i t o k	d v u nj i t k a
d v u x lj e t o k	d v u x lj e t k a
dj e lj e ts	dj e lj ts a
dj e lj i j e ts	dj e lj i j ts a
dj e nj o k	dj e nj k a
dj e nj o ch e k	dj e nj o ch k a
dj e nj	d nj a
dj e p o vj e ts	dj e p o v ts a
dj e sj a tj i b o rj e ts	dj e sj a tj i b o r ts a
dj e sj a t o k	dj e sj a t k a
dj e sj a t o ch e k	dj e sj a t o ch k a
dj e t d o m o vj e ts	dj e t d o m o v ts a
dj e tj i nj e ts	dj e tj i n ts a
dj i n a m o vj e ts	dj i n a m o v ts a
dj i ch o k	dj i ch k a
dj i ch o k	dj i ch k a
d o b a v o k	d o b a v k a
d o b r o v o lj e ts	d o b r o v o lj ts a
d o b rj a ch o k	d o b rj a ch k a
d o b i t o k	d o b i t k a
d o vj e s o k	d o vj e s k a
d o vj e s o ch e k	d o vj e s o ch k a
d o zh dj i ch e k	d o zh dj i ch k a
d o l g u nj e ts	d o l g u n ts a
d o l zh o k	d o l zh k a
d o mj i nj i k a nj e ts	d o mj i nj i k a n ts a
d o m o v l a dj e lj e ts	d o m o v l a dj e lj ts a
d o m o k	d o m k a
d o m o ch a dj e ts	d o m o ch a d ts a
d o m i sj e l	d o m i s l a
d o nj e ts	d o n ts a
d o rj i j e ts	d o rj i j ts a
d o s a a f o vj e ts	d o s a a f o v ts a
d o s t a t o k	d o s t a t k a
d o x o dj e ts	d o x o d ts a
d r a m k r u zh o k	d r a m k r u zh k a
d rj e v o t o ch e ts	d rj e v o t o ch ts a
d r u zh o k	d r u zh k a
d r u zh o ch e k	d r u zh o ch k a
d rj u ch o k	d rj u ch k a
d u b o k	d u b k a
d u b o ch e k	d u b o ch k a
d u mj e ts	d u m ts a
d u r a ch o k	d u r a ch k a
d u rj e nj	d u r nj a
d u x o b o rj e ts	d u x o b o r ts a
d u x o vj i dj e ts	d u x o vj i d ts a
d u sh e g u bj e ts	d u sh e g u b ts a
d u sh o k	d u sh k a
dj j a ch o k	dj j a ch k a
dj a tj e l	dj a t l a
j e v r a zj i j e ts	j e v r a zj i j ts a
j e v r o pj e j e ts	j e v r o pj e j ts a
j e dj i n o b o rj e ts	j e dj i n o b o r ts a
j e dj i n o vj e rj e ts	j e dj i n o vj e r ts a
j e lj e ts	j e lj ts a
j e lj nj i ch e k	j e lj nj i ch k a
j e fj i m o k	j e fj i m k a
zh a v o r o n o k	zh a v o r o n k a
zh a v o r o n o k	zh a v o r o n k a
zh g u tj i k o n o sj e ts	zh g u tj i k o n o s ts a
zh e v o k	zh e v k a
zh e l v a ch o k	zh e l v a ch k a
zh e l o b o k	zh e l o b k a
zh e l t o k	zh e l t k a
zh e l t o k o rj e nj	zh e l t o k o r nj a
zh e l u d o k	zh e l u d k a
zh e l u d o ch e k	zh e l u d o ch k a
zh e nj i sh o k	zh e nj i sh k a
zh e n o lj u bj e ts	zh e n o lj u b ts a
zh e rj e bj e j	zh e rj e bj j a
zh e rj e bj e ts	zh e rj e b ts a
zh e rj e b o k	zh e rj e b k a
zh e r n o v o k	zh e r n o v k a
zh i vj e ts	zh i v ts a
zh i v o pj i sj e ts	zh i v o pj i s ts a
zh i z nj e lj u bj e ts	zh i z nj e lj u b ts a
zh i lj e ts	zh i lj ts a
zh u r a vj e lj	zh u r a v lj a
zh u ch o k	zh u ch k a
zh u ch o k	zh u ch k a
z a b a j k a lj e ts	z a b a j k a lj ts a
z a vj i t o k	z a vj i t k a
z a vj i t o ch e k	z a vj i t o ch k a
z a v k o m o vj e ts	z a v k o m o v ts a
z a g o l o v o k	z a g o l o v k a
z a g o r b o k	z a g o r b k a
z a g rj i v o k	z a g rj i v k a
z a d a t o k	z a d a t k a
z a d o k	z a d k a
z a j o m	z a j m a
z a zj i m o k	z a zj i m k a
z a j i m o d a vj e ts	z a j i m o d a v ts a
z a k a zj e ts	z a k a z ts a
z a k lj i n o k	z a k lj i n k a
z a k o u l o k	z a k o u l k a
z a k o u l o ch e k	z a k o u l o ch k a
z a k r a j e k	z a k r a j k a
z a k r i l o k	z a k r i l k a
z a k u t o k	z a k u t k a
z a l a v o k	z a l a v k a
z a m o k	z a m k a
z a m o k	z a m k a
z a m o r o z o k	z a m o r o z k a
z a m o ch e k	z a m o ch k a
z a m i sj e l	z a m i s l a
z a p a d n o bj e r lj i nj e ts	z a p a d n o bj e r lj i n ts a
z a p a sj e ts	z a p a s ts a
z a p a sh o k	z a p a sh k a
z a pj e ch e k	z a pj e ch k a
z a p o r o zh e ts	z a p o r o zh ts a
z a p o r o zh e ts	z a p o r o zh ts a
z a r a b o t o k	z a r a b o t k a
z a r o s t o k	z a r o s t k a
z a s tj e n o k	z a s tj e n k a
z a tj i sh e k	z a tj i sh k a
z a t i l o k	z a t i l k a
z a t i l o ch e k	z a t i l o ch k a
z a u l o k	z a u l k a
z a u sj e nj e ts	z a u sj e n ts a
z a ch a t o k	z a ch a t k a
z a sh e j e k	z a sh e j k a
z a j a ts	z a j ts a
z vj e z d o n o sj e ts	z vj e z d o n o s ts a
z vj e rj o k	z vj e rj k a
z vj e rj i nj e ts	z vj e rj i n ts a
z vj e r o k	z vj e r k a
z v o nj e ts	z v o n ts a
z v o n o k	z v o n k a
z v o n o ch e k	z v o n o ch k a
zj e v o k	zj e v k a
zj e lj e nj e ts	zj e lj e n ts a
zj e mj e ts	zj e m ts a
zj e m lj e v l a dj e lj e ts	zj e m lj e v l a dj e lj ts a
zj e m lj e dj e lj e ts	zj e m lj e dj e lj ts a
zj e m lj e p a sh e ts	zj e m lj e p a sh ts a
zj e m lj e p r o x o dj e ts	zj e m lj e p r o x o d ts a
zj e m lj a ch o k	zj e m lj a ch k a
z l i dj e nj	z l i d nj a
z mj e j e b o rj e ts	z mj e j e b o r ts a
z n a k o mj e ts	z n a k o m ts a
z n a mj e n o sj e ts	z n a mj e n o s ts a
z n a ch o k	z n a ch k a
z o l o t o r o tj e ts	z o l o t o r o t ts a
z r a ch o k	z r a ch k a
z u bj e ts	z u b ts a
z u b o k	z u b k a
z u dj e nj	z u d nj a
z u j o k	z u j k a
zj a tj o k	zj a tj k a
j i vj i sh e nj	j i vj i sh nj a
j i v nj a ch o k	j i v nj a ch k a
j i g r u n o k	j i g r u n k a
j i zh dj i vj e nj e ts	j i zh dj i vj e n ts a
j i z b i t o k	j i z b i t k a
j i z g o l o v o k	j i z g o l o v k a
j i z lj i sh e k	j i z lj i sh k a
j i z r a zj e ts	j i z r a z ts a
j i z r a j i lj e ts	j i z r a j i lj ts a
j i z j a nj e ts	j i z j a n ts a
j i k o n o b o rj e ts	j i k o n o b o r ts a
j i k o n o pj i sj e ts	j i k o n o pj i s ts a
j i l lj i rj i j e ts	j i l lj i rj i j ts a
j i mj e rj e tj i nj e ts	j i mj e rj e tj i n ts a
j i n dj e j e ts	j i n dj e j ts a
j i n dj i j e ts	j i n dj i j ts a
j i n d o j e v r o pj e j e ts	j i n d o j e v r o pj e j ts a
j i n d o nj e zj i j e ts	j i n d o nj e zj i j ts a
j i n o vj e rj e ts	j i n o vj e r ts a
j i n o zj e mj e ts	j i n o zj e m ts a
j i n o r o dj e ts	j i n o r o d ts a
j i n o s t r a nj e ts	j i n o s t r a n ts a
j i n o x o dj e ts	j i n o x o d ts a
j i o nj i j e ts	j i o nj i j ts a
j i o r d a nj e ts	j i o r d a n ts a
j i r a kj e ts	j i r a k ts a
j i r a nj e ts	j i r a n ts a
j i rj e j	j i rj j a
j i r l a n dj e ts	j i r l a n d ts a
j i s k r o vj e ts	j i s k r o v ts a
j i s l a n dj e ts	j i s l a n d ts a
j i s p a nj e ts	j i s p a n ts a
j i s p o l k o m o vj e ts	j i s p o l k o m o v ts a
j i s tj e ts	j i s t ts a
j i t a lj j a nj e ts	j i t a lj j a n ts a
j i sh a ch o k	j i sh a ch k a
j j e mj e nj e ts	j j e mj e n ts a
k a b a r dj i nj e ts	k a b a r dj i n ts a
k a b a ch o k	k a b a ch k a
k a b l u ch o k	k a b l u ch k a
k a v k a zj e ts	k a v k a z ts a
k a g a nj e ts	k a g a n ts a
k a z a n o k	k a z a n k a
k a z a ch o k	k a z a ch k a
k a z a ch o k	k a z a ch k a
k a m b o d zh i j e ts	k a m b o d zh i j ts a
k a mj e lj o k	k a mj e lj k a
k a mj e n o b o j e ts	k a mj e n o b o j ts a
k a mj e nj	k a m nj a
k a mj e sh e k	k a mj e sh k a
k a m u sh e k	k a m u sh k a
k a n a dj e ts	k a n a d ts a
k a n a t o x o dj e ts	k a n a t o x o d ts a
k a n tj i a nj e ts	k a n tj i a n ts a
k a pj i t a lj e ts	k a pj i t a lj ts a
k a p o k	k a p k a
k a r a ch a j e vj e ts	k a r a ch a j e v ts a
k a r b o v a nj e ts	k a r b o v a n ts a
k a r m a sh e k	k a r m a sh k a
k a r tj e zj i a nj e ts	k a r tj e zj i a n ts a
k a s pj i j e ts	k a s pj i j ts a
k a t a l o nj e ts	k a t a l o n ts a
k a tj e r o k	k a tj e r k a
k a t o k	k a t k a
k a t i sh e k	k a t i sh k a
k a u t s kj i a nj e ts	k a u t s kj i a n ts a
k a xj e tj i nj e ts	k a xj e tj i n ts a
k a sh e lj	k a sh lj a
k a sh mj i rj e ts	k a sh mj i r ts a
k vj i t o k	k vj i t k a
kj e gj e lj	kj e g lj a
kj i v o k	kj i v k a
kj i j o k	kj i j k a
kj i m mj e rj i j e ts	kj i m mj e rj i j ts a
kj i t a j e ts	kj i t a j ts a
kj i t o b o j e ts	kj i t o b o j ts a
k l a dj e nj e ts	k l a dj e n ts a
k lj e v o k	k lj e v k a
k lj e n o k	k lj e n k a
k lj i n o k	k lj i n k a
k lj i n i sh e k	k lj i n i sh k a
k l o ch o k	k l o ch k a
k l o ch o ch e k	k l o ch o ch k a
k l u bj e nj o k	k l u bj e nj k a
k l u bj e nj	k l u b nj a
k l u b o k	k l u b k a
k l u b o ch e k	k l u b o ch k a
k nj i g o p r o d a vj e ts	k nj i g o p r o d a v ts a
k nj i g o t o r g o vj e ts	k nj i g o t o r g o v ts a
k nj a zj o k	k nj a zj k a
k o bj o l	k o b l a
k o bj e lj o k	k o bj e lj k a
k o vj o r	k o v r a
k o v ch e zh e ts	k o v ch e zh ts a
k o g o t o k	k o g o t k a
k o g o tj	k o g tj a
k o zh u sh o k	k o zh u sh k a
k o zj o l	k o z l a
k o zj o l	k o z l a
k o zj e lj e ts	k o zj e lj ts a
k o z o n	k o z n a
k o z o n o k	k o z o n k a
k o z i rj o k	k o z i rj k a
k o l o b o k	k o l o b k a
k o l o dj e ts	k o l o d ts a
k o l o k	k o l k a
k o l o n o k	k o l o n k a
k o l o n o k	k o l o n k a
k o l o s o k	k o l o s k a
k o l p a ch o k	k o l p a ch k a
k o l ch a k o vj e ts	k o l ch a k o v ts a
k o l i sh e k	k o l i sh k a
k o mj e lj o k	k o mj e lj k a
k o mj e lj	k o m lj a
k o m o k	k o m k a
k o m o ch e k	k o m o ch k a
k o m s o m o lj e ts	k o m s o m o lj ts a
k o n g o lj e zj e ts	k o n g o lj e z ts a
k o n d a ch o k	k o n d a ch k a
k o nj o k	k o nj k a
k o nj o k	k o nj k a
k o nj e ts	k o n ts a
k o n n o g v a r dj e j e ts	k o n n o g v a r dj e j ts a
k o n sj e r v a t o rj e ts	k o n sj e r v a t o r ts a
k o n t r mj i n o n o sj e ts	k o n t r mj i n o n o s ts a
k o nj k o bj e zh e ts	k o nj k o bj e zh ts a
k o pj o r	k o p r a
k o p i tj e nj	k o p i t nj a
k o pj j e n o sj e ts	k o pj j e n o s ts a
k o rj e j e ts	k o rj e j ts a
k o rj e nj	k o r nj a
k o rj e ts	k o r ts a
k o rj e sh o k	k o rj e sh k a
k o r mj i lj e ts	k o r mj i lj ts a
k o r nj i l o vj e ts	k o r nj i l o v ts a
k o r o b o k	k o r o b k a
k o r o lj o k	k o r o lj k a
k o r o lj o k	k o r o lj k a
k o r sj i k a nj e ts	k o r sj i k a n ts a
k o r i s t o lj u bj e ts	k o r i s t o lj u b ts a
k o sj e ts	k o s ts a
k o s o k	k o s k a
k o s tj o r	k o s t r a
k o s tj e r o k	k o s tj e r k a
k o sj a ch o k	k o sj a ch k a
k o tj o l	k o t l a
k o tj e l o k	k o tj e l k a
k o ch a n	k o ch n a
k o ch e t o k	k o ch e t k a
k o ch e t o k	k o ch e t k a
k o ch e sh o k	k o ch e sh k a
k o sh e lj o k	k o sh e lj k a
k o sh e lj o ch e k	k o sh e lj o ch k a
k r a j e sh e k	k r a j e sh k a
k r a nj e ts	k r a n ts a
k r a s a vj e ts	k r a s a v ts a
k r a s n o a r mj e j e ts	k r a s n o a r mj e j ts a
k r a s n o g v a r dj e j e ts	k r a s n o g v a r dj e j ts a
k r a s n o dj e rj e vj e ts	k r a s n o dj e rj e v ts a
k r a s n o d o nj e ts	k r a s n o d o n ts a
k r a s n o z n a mj o nj e ts	k r a s n o z n a mj o n ts a
k r a s n o rj a dj e ts	k r a s n o rj a d ts a
k r a s n o f l o tj e ts	k r a s n o f l o t ts a
k rj e mj e nj	k rj e m nj a
k rj e mj e sh o k	k rj e mj e sh k a
k rj e n dj e lj o k	k rj e n dj e lj k a
k rj e s tj e ts	k rj e s t ts a
k rj e s t o n o sj e ts	k rj e s t o n o s ts a
k r o v o pj i vj e ts	k r o v o pj i v ts a
k r o m a nj o nj e ts	k r o m a nj o n ts a
k r u zh k o vj e ts	k r u zh k o v ts a
k r u zh o k	k r u zh k a
k r u zh o ch e k	k r u zh o ch k a
k rj u ch k o t v o rj e ts	k rj u ch k o t v o r ts a
k rj u ch o k	k rj u ch k a
k rj u ch o ch e k	k rj u ch o ch k a
k u b a nj e ts	k u b a n ts a
k u bj i nj e ts	k u bj i n ts a
k u b o k	k u b k a
k u v i r o k	k u v i r k a
k u z o v o k	k u z o v k a
k u k l u k s k l a n o vj e ts	k u k l u k s k l a n o v ts a
k u l a ch o k	k u l a ch k a
k u lj o k	k u lj k a
k u lj o ch e k	k u lj o ch k a
k u lj i ch o k	k u lj i ch k a
k u m a nj o k	k u m a nj k a
k u pj e ts	k u p ts a
k u p o l o k	k u p o l k a
k u r o k	k u r k a
k u s o k	k u s k a
k u s o ch e k	k u s o ch k a
k u s t o k	k u s t k a
k u s t o ch e k	k u s t o ch k a
k u t o k	k u t k a
k u sh a ch o k	k u sh a ch k a
kj u rj i nj e ts	kj u rj i n ts a
l a o sj e ts	l a o s ts a
l a p l a n dj e ts	l a p l a n d ts a
l a p o t o k	l a p o t k a
l a p o tj	l a p tj a
l a p o tj	l a p tj a
l a rj o k	l a rj k a
l a rj e ts	l a r ts a
l a s s a lj j a nj e ts	l a s s a lj j a n ts a
l a t vj i j e ts	l a t vj i j ts a
l a t g a lj e ts	l a t g a lj ts a
lj e v a n tj i nj e ts	lj e v a n tj i n ts a
lj e dj e nj e ts	lj e dj e n ts a
lj e zh e nj	lj e zh nj a
lj e zh e nj	lj e zh nj a
lj e nj i vj e ts	lj e nj i v ts a
lj e nj i n g r a dj e ts	lj e nj i n g r a d ts a
lj e nj i nj e ts	lj e nj i n ts a
lj e n o k	lj e n k a
lj e pj e s t o k	lj e pj e s t k a
lj e pj e s t o ch e k	lj e pj e s t o ch k a
lj e s o k	lj e s k a
lj e s o t o r g o vj e ts	lj e s o t o r g o v ts a
lj e s o ch e k	lj e s o ch k a
lj e t o k	lj e t k a
lj e t o pj i sj e ts	lj e t o pj i s ts a
lj e t o pj i sj e ts	lj e t o pj i s ts a
lj i v a nj e ts	lj i v a n ts a
lj i vj e nj	lj i v nj a
lj i nj o k	lj i nj k a
lj i pj e ts	lj i p ts a
lj i s t o k	lj i s t k a
lj i s t o ch e k	lj i s t o ch k a
lj i t k r u zh o k	lj i t k r u zh k a
lj i t o vj e ts	lj i t o v ts a
lj i x o j i mj e ts	lj i x o j i m ts a
lj i sh e nj e ts	lj i sh e n ts a
l o b o k	l o b k a
l o vj e ts	l o v ts a
l o zh o k	l o zh k a
l o k o t o k	l o k o t k a
l o k o tj	l o k tj a
l o m o tj	l o m tj a
l o n d o nj e ts	l o n d o n ts a
l o p u sh o k	l o p u sh k a
l o p u sh o k	l o p u sh k a
l o s k u t o k	l o s k u t k a
l o t o k	l o t k a
l o t o ch e k	l o t o ch k a
l u b o k	l u b k a
l u k a vj e ts	l u k a v ts a
l u ch o k	l u ch k a
lj u bj i mj e ts	lj u bj i m ts a
lj u bj i s t o k	lj u bj i s t k a
m a z o k	m a z k a
m a k a nj e ts	m a k a n ts a
m a kj e d o nj e ts	m a kj e d o n ts a
m a l a j e ts	m a l a j ts a
m a lj o k	m a lj k a
m a lj e ts	m a lj ts a
m a lj i j e ts	m a lj i j ts a
m a l o lj e t o k	m a l o lj e t k a
m a l o mj e r o k	m a l o mj e r k a
m a l o mj e r o k	m a l o mj e r k a
m a l i sh o k	m a l i sh k a
m a lj t u zj i a nj e ts	m a lj t u zj i a n ts a
m a n o k	m a n k a
m a n o k	m a n k a
m a n sj i j e ts	m a n sj i j ts a
m a r a f o nj e ts	m a r a f o n ts a
m a r g a nj e ts	m a r g a n ts a
m a rj i j e ts	m a rj i j ts a
m a r o k k a nj e ts	m a r o k k a n ts a
m a r tj e n o vj e ts	m a r tj e n o v ts a
m a r sh b r o s o k	m a r sh b r o s k a
m a s tj e r o k	m a s tj e r k a
m a x n o vj e ts	m a x n o v ts a
m a j a ch o k	m a j a ch k a
mj e d a lj e n o sj e ts	mj e d a lj e n o s ts a
mj e zh e u m o k	mj e zh e u m k a
mj e zh e u m o k	mj e zh e u m k a
mj e k sj i k a nj e ts	mj e k sj i k a n ts a
mj e l a nj e zj i j e ts	mj e l a nj e zj i j ts a
mj e r z a vj e ts	mj e r z a v ts a
mj e rj i n o k	mj e rj i n k a
mj e s t k o m o vj e ts	mj e s t k o m o v ts a
mj e t r o p o lj i tj e n o vj e ts	mj e t r o p o lj i tj e n o v ts a
mj e t r o s t r o j e vj e ts	mj e t r o s t r o j e v ts a
mj e ch e n o sj e ts	mj e ch e n o s ts a
mj e sh o k	mj e sh k a
mj e sh o k	mj e sh k a
mj e sh o ch e k	mj e sh o ch k a
m z d o j i mj e ts	m z d o j i m ts a
mj i zj i nj e ts	mj i zj i n ts a
mj i lj o n o k	mj i lj o n k a
mj i l o k	mj i l k a
mj i l o s tj i vj e ts	mj i l o s tj i v ts a
mj i n g rj e lj e ts	mj i n g rj e lj ts a
mj i n o n o sj e ts	mj i n o n o s ts a
mj i r o k	mj i r k a
mj i r o lj u bj e ts	mj i r o lj u b ts a
mj i r o t v o rj e ts	mj i r o t v o r ts a
mj i ch u rj i nj e ts	mj i ch u rj i n ts a
m l a dj e nj e ts	m l a dj e n ts a
m l a d o gj e gj e lj j a nj e ts	m l a d o gj e gj e lj j a n ts a
m n o g o b o rj e ts	m n o g o b o r ts a
m n o g o zh e nj e ts	m n o g o zh e n ts a
m o z zh e ch o k	m o z zh e ch k a
m o lj e bj e n	m o lj e b n a
m o l o dj e ts	m o l o d ts a
m o l o d o g v a r dj e j e ts	m o l o d o g v a r dj e j ts a
m o l o t o b o j e ts	m o l o t o b o j ts a
m o l o t o k	m o l o t k a
m o l o t o ch e k	m o l o t o ch k a
m o n a sh e k	m o n a sh k a
m o r d o vj e ts	m o r d o v ts a
m o rj e x o dj e ts	m o rj e x o d ts a
m o r o zj e ts	m o r o z ts a
m o rj a ch o k	m o rj a ch k a
m o s o l	m o s l a
m o s t o k	m o s t k a
m o t o k	m o t k a
m o t o pj e x o tj i nj e ts	m o t o pj e x o tj i n ts a
m o t o ch e k	m o t o ch k a
m o t i lj o k	m o t i lj k a
m u zh e nj o k	m u zh e nj k a
m u zh i ch o k	m u zh i ch k a
m u lj o k	m u lj k a
m u n d sh t u ch o k	m u n d sh t u ch k a
m u r a vj e j	m u r a vj j a
m i s o k	m i s k a
m i shshj e l o k	m i shshj e l k a
n a b r o s o k	n a b r o s k a
n a vj a zj e nj	n a vj a z nj a
n a d g l a v o k	n a d g l a v k a
n a d sh i v o k	n a d sh i v k a
n a j o m	n a j m a
n a z n a ch e nj e ts	n a z n a ch e n ts a
n a z u b o k	n a z u b k a
n a lj i t o k	n a lj i t k a
n a n a j e ts	n a n a j ts a
n a pj o r s t o k	n a pj o r s t k a
n a pj o r s t o ch e k	n a pj o r s t o ch k a
n a pj i l o k	n a pj i l k a
n a pj i t o k	n a pj i t k a
n a r o dj e ts	n a r o d ts a
n a r o d o v o lj e ts	n a r o d o v o lj ts a
n a r o d o lj u bj e ts	n a r o d o lj u b ts a
n a xj i m o vj e ts	n a xj i m o v ts a
nj e a n dj e r t a lj e ts	nj e a n dj e r t a lj ts a
nj e a p o lj i t a nj e ts	nj e a p o lj i t a n ts a
nj e v o z v r a shshj e nj e ts	nj e v o z v r a shshj e n ts a
nj e d o bj i t o k	nj e d o bj i t k a
nj e d o vj e s o k	nj e d o vj e s k a
nj e d o mj e r o k	nj e d o mj e r k a
nj e d o mj e r o k	nj e d o mj e r k a
nj e d o n o s o k	nj e d o n o s k a
nj e d o r o s t o k	nj e d o r o s t k a
nj e d o r o s t o k	nj e d o r o s t k a
nj e d o s t a t o k	nj e d o s t a t k a
nj e d o u z d o k	nj e d o u z d k a
nj e d o u m o k	nj e d o u m k a
nj e z n a k o mj e ts	nj e z n a k o m ts a
nj e mj e ts	nj e m ts a
nj e nj e ts	nj e n ts a
nj e o gj e gj e lj j a nj e ts	nj e o gj e gj e lj j a n ts a
nj e o k a n tj i a nj e ts	nj e o k a n tj i a n ts a
nj e o m a lj t u zj i a nj e ts	nj e o m a lj t u zj i a n ts a
nj e p a lj e ts	nj e p a lj ts a
nj e p o rj a d o k	nj e p o rj a d k a
nj e p r o tj i v lj e nj e ts	nj e p r o tj i v lj e n ts a
nj e r a dj i vj e ts	nj e r a dj i v ts a
nj e s m i s lj o n o ch e k	nj e s m i s lj o n o ch k a
nj e s ch a s t lj i vj e ts	nj e s ch a s t lj i v ts a
nj e f tj e p r o m i sj e l	nj e f tj e p r o m i s l a
nj e ch e s tj i vj e ts	nj e ch e s tj i v ts a
nj i gj e rj i j e ts	nj i gj e rj i j ts a
nj i dj e r l a n dj e ts	nj i dj e r l a n d ts a
nj i z o k	nj i z k a
nj i ts sh e a nj e ts	nj i ts sh e a n ts a
n o v g o r o dj e ts	n o v g o r o d ts a
n o vj i ch o k	n o vj i ch k a
n o v o b r a nj e ts	n o v o b r a n ts a
n o v o zj e l a n dj e ts	n o v o zj e l a n d ts a
n o v o p o sj e lj e nj e ts	n o v o p o sj e lj e n ts a
n o g a j e ts	n o g a j ts a
n o g o t o k	n o g o t k a
n o g o tj	n o g tj a
n o zh i ch e k	n o zh i ch k a
n o mj e r o k	n o mj e r k a
n o r vj e zh e ts	n o r vj e zh ts a
n o r m a n dj e ts	n o r m a n d ts a
n o s o k	n o s k a
n o s o ch e k	n o s o ch k a
n o t o n o sj e ts	n o t o n o s ts a
n o ch nj i ch o k	n o ch nj i ch k a
n u bj i j e ts	n u bj i j ts a
n i r o k	n i r k a
n i r o k	n i r k a
nj j u j o r kj e ts	nj j u j o r k ts a
o b a b o k	o b a b k a
o b g l o d o k	o b g l o d k a
o b zh i n o k	o b zh i n k a
o b k o m o vj e ts	o b k o m o v ts a
o b l o m o k	o b l o m k a
o b l o m o ch e k	o b l o m o ch k a
o b l u ch o k	o b l u ch k a
o b mj e r o k	o b mj e r k a
o b m i l o k	o b m i l k a
o b nj i z o k	o b nj i z k a
o b n o v lj e nj e ts	o b n o v lj e n ts a
o b n o s o k	o b n o s k a
o b o d o k	o b o d k a
o b o d r a nj e ts	o b o d r a n ts a
o b o r v a nj e ts	o b o r v a n ts a
o b o r o nj e ts	o b o r o n ts a
o b o r o tj e nj	o b o r o t nj a
o b r a zj e ts	o b r a z ts a
o b r a z o k	o b r a z k a
o b r a z o ch e k	o b r a z o ch k a
o b rj e z o k	o b rj e z k a
o b r u b o k	o b r u b k a
o b r i v o k	o b r i v k a
o b r i v o ch e k	o b r i v o ch k a
o b sj e v o k	o b sj e v k a
o b u sh o k	o b u sh k a
o b sh l a zh o k	o b sh l a zh k a
o b j e d o k	o b j e d k a
o vj e n	o v n a
o vj o s	o v s a
o v r a zh e k	o v r a zh k a
o v r a zh e k	o v r a zh k a
o g a r o k	o g a r k a
o g a r o ch e k	o g a r o ch k a
o g l o d o k	o g l o d k a
o g nj e zj e mj e lj e ts	o g nj e zj e mj e lj ts a
o g o lj e ts	o g o lj ts a
o g o l o v o k	o g o l o v k a
o g o nj o k	o g o nj k a
o g o nj o ch e k	o g o nj o ch k a
o g o nj	o g nj a
o g o r o dj e ts	o g o r o d ts a
o g r i z o k	o g r i z k a
o g u z o k	o g u z k a
o g u rj e ts	o g u r ts a
o dj o r	o d r a
o d n o g o d o k	o d n o g o d k a
o d n o d v o rj e ts	o d n o d v o r ts a
o d n o lj e t o k	o d n o lj e t k a
o d n o f a mj i lj e ts	o d n o f a mj i lj ts a
o zh i n o k	o zh i n k a
o kj i sj e l	o kj i s l a
o k o v a l o k	o k o v a l k a
o k o l o t o k	o k o l o t k a
o k o rj o n o k	o k o rj o n k a
o k u nj o k	o k u nj k a
o k u r o k	o k u r k a
o l a d u sh e k	o l a d u sh k a
o l a d i sh e k	o l a d i sh k a
o lj e sh e k	o lj e sh k a
o lj i m pj i j e ts	o lj i m pj i j ts a
o p a sh e nj	o p a sh nj a
o pj o n o k	o pj o n k a
o p o j e k	o p o j k a
o p o j e k	o p o j k a
o p o l zj e nj	o p o l z nj a
o p o l ch e nj e ts	o p o l ch e n ts a
o p o r o k	o p o r k a
o p o j a s o k	o p o j a s k a
o p r o shshj e nj e ts	o p r o shshj e n ts a
o r dj e n o k	o r dj e n k a
o r dj e n o n o sj e ts	o r dj e n o n o s ts a
o r dj i n a rj e ts	o r dj i n a r ts a
o r d i nj e ts	o r d i n ts a
o rj o l	o r l a
o rj e sh e k	o rj e sh k a
o r l o vj e ts	o r l o v ts a
o r u d o vj e ts	o r u d o v ts a
o r u zh e n o sj e ts	o r u zh e n o s ts a
o s a d o k	o s a d k a
o sj o l	o s l a
o sj e lj e dj e ts	o sj e lj e d ts a
o sj e l o k	o sj e l k a
o s k o l o k	o s k o l k a
o s k o l o ch e k	o s k o l o ch k a
o s m a nj e ts	o s m a n ts a
o s o b nj a ch o k	o s o b nj a ch k a
o s t a t o k	o s t a t k a
o s t zj e j e ts	o s t zj e j ts a
o s t r o v o k	o s t r o v k a
o s t r o zh e k	o s t r o zh k a
o s t r o u mj e ts	o s t r o u m ts a
o t vj e r zh e nj e ts	o t vj e r zh e n ts a
o t v o d o k	o t v o d k a
o t g o l o s o k	o t g o l o s k a
o tj e ts	o t ts a
o t zh i l o k	o t zh i l k a
o t k o r m o k	o t k o r m k a
o t k r i l o k	o t k r i l k a
o t o p lj e nj e ts	o t o p lj e n ts a
o t o p o k	o t o p k a
o t pj e ch a t o k	o t pj e ch a t k a
o t pj i l o k	o t pj i l k a
o t rj e z o k	o t rj e z k a
o t r o j e k	o t r o j k a
o t r o zh e k	o t r o zh k a
o t r o s t o k	o t r o s t k a
o t r i v o k	o t r i v k a
o t r i v o ch e k	o t r i v o ch k a
o t s a d o k	o t s a d k a
o t sj o l o k	o t sj o l k a
o t tj e n o k	o t tj e n k a
o t shshj e pj e nj e ts	o t shshj e pj e n ts a
o x a bj e nj	o x a b nj a
o x l o p o k	o x l o p k a
o x o t n o rj a dj e ts	o x o t n o rj a d ts a
o ts e t	o ts t a
o ch a zh o k	o ch a zh k a
o ch e vj i dj e ts	o ch e vj i d ts a
o ch i t o k	o ch i t k a
o sh e j e k	o sh e j k a
o sh mj o t o k	o sh mj o t k a
p a v o d o k	p a v o d k a
p a v o z o k	p a v o z k a
p a g o lj e n o k	p a g o lj e n k a
p a d a nj e ts	p a d a n ts a
p a d i m o k	p a d i m k a
p a j o k	p a j k a
p a z a n o k	p a z a n k a
p a z o k	p a z k a
p a kj i s t a nj e ts	p a kj i s t a n ts a
p a lj e ts	p a lj ts a
p a r a g v a j e ts	p a r a g v a j ts a
p a rj e nj o k	p a rj e nj k a
p a rj e nj	p a r nj a
p a rj i ch o k	p a rj i ch k a
p a r n a sj e ts	p a r n a s ts a
p a r o vj i ch o k	p a r o vj i ch k a
p a r tj i j e ts	p a r tj i j ts a
p a r u b o k	p a r u b k a
p a r u s o k	p a r u s k a
p a r sh i vj e ts	p a r sh i v ts a
p a s t u sh o k	p a s t u sh k a
p a s i n o k	p a s i n k a
p a t r u b o k	p a t r u b k a
p a u z o k	p a u z k a
p a u ch o k	p a u ch k a
p a shshj e n o k	p a shshj e n k a
pj e vj e ts	pj e v ts a
pj e kj i nj e ts	pj e kj i n ts a
pj e lj mj e sh e k	pj e lj mj e sh k a
pj e nj o k	pj e nj k a
pj e nj o ch e k	pj e nj o ch k a
pj e nj	p nj a
pj e r vj e nj e ts	pj e r vj e n ts a
pj e r v o g o d o k	pj e r v o g o d k a
pj e r v o zj i m o k	pj e r v o zj i m k a
pj e r v o p o sj e lj e nj e ts	pj e r v o p o sj e lj e n ts a
pj e r v o p r o x o dj e ts	pj e r v o p r o x o d ts a
pj e r v o p u t o k	pj e r v o p u t k a
pj e rj e v a lj e ts	pj e rj e v a lj ts a
pj e rj e vj e dj e nj e ts	pj e rj e vj e dj e n ts a
pj e rj e vj e r tj e nj	pj e rj e vj e r t nj a
pj e rj e d nj i ch e k	pj e rj e d nj i ch k a
pj e rj e d o k	pj e rj e d k a
pj e rj e zh i t o k	pj e rj e zh i t k a
pj e rj e j i z b i t o k	pj e rj e j i z b i t k a
pj e rj e k rj o s t o k	pj e rj e k rj o s t k a
pj e rj e k rj e shshj e nj e ts	pj e rj e k rj e shshj e n ts a
pj e rj e lj e s o k	pj e rj e lj e s k a
pj e rj e n a j o m	pj e rj e n a j m a
pj e rj e n o s o k	pj e rj e n o s k a
pj e rj e p r o d a vj e ts	pj e rj e p r o d a v ts a
pj e rj e r o zh dj e nj e ts	pj e rj e r o zh dj e n ts a
pj e rj e r o s t o k	pj e rj e r o s t k a
pj e rj e r o s t o k	pj e rj e r o s t k a
pj e rj e s a d o k	pj e rj e s a d k a
pj e rj e sj e lj e nj e ts	pj e rj e sj e lj e n ts a
pj e rj e s t a r o k	pj e rj e s t a r k a
pj e rj e u l o k	pj e rj e u l k a
pj e rj e u l o ch e k	pj e rj e u l o ch k a
pj e rj e ch e nj	pj e rj e ch nj a
pj e rj e sh e j e k	pj e rj e sh e j k a
pj e rj e j a r o k	pj e rj e j a r k a
pj e r s tj e nj o k	pj e r s tj e nj k a
pj e r s tj e nj	pj e r s t nj a
pj e r s tj e nj	pj e r s t nj a
pj e r u a nj e ts	pj e r u a n ts a
pj o s	p s a
pj e sj e ts	pj e s ts a
pj e s n o pj e vj e ts	pj e s n o pj e v ts a
pj e s n o t v o rj e ts	pj e s n o t v o r ts a
pj e tj e r b u r zh e ts	pj e tj e r b u r zh ts a
pj e t lj u r o vj e ts	pj e t lj u r o v ts a
pj e t r a sh e vj e ts	pj e t r a sh e v ts a
pj e t r o g r a dj e ts	pj e t r o g r a d ts a
pj e t u sh o k	pj e t u sh k a
pj e x o tj i nj e ts	pj e x o tj i n ts a
pj i d zh a ch o k	pj i d zh a ch k a
pj i n o k	pj i n k a
pj i r o zh o k	pj i r o zh k a
pj i sj e ts	pj i s ts a
pj i sj m o n o sj e ts	pj i sj m o n o s ts a
pj i t o mj e ts	pj i t o m ts a
pj i f a g o rj e j e ts	pj i f a g o rj e j ts a
p l a vj e nj	p l a v nj a
p l a v nj i ch o k	p l a v nj i ch k a
p l a v u nj e ts	p l a v u n ts a
p l a t o k	p l a t k a
p l a t o ch e k	p l a t o ch k a
p lj e v o k	p lj e v k a
p lj e mj a n nj i ch e k	p lj e mj a n nj i ch k a
p lj e tj e nj	p lj e t nj a
p l o vj e ts	p l o v ts a
p lj u g a vj e ts	p lj u g a v ts a
p o v o d o k	p o v o d k a
p o v s t a nj e ts	p o v s t a n ts a
p o g a nj e ts	p o g a n ts a
p o g o d o k	p o g o d k a
p o g o rj e lj e ts	p o g o rj e lj ts a
p o g rj e bj e ts	p o g rj e b ts a
p o g rj e b o k	p o g rj e b k a
p o g rj e m o k	p o g rj e m k a
p o d a r o k	p o d a r k a
p o d a r o ch e k	p o d a r o ch k a
p o d bj e dj o r o k	p o d bj e dj o r k a
p o d vj e s o k	p o d vj e s k a
p o d vj i sh e nj	p o d vj i sh nj a
p o d v o r o t nj i ch o k	p o d v o r o t nj i ch k a
p o d g o l o v o k	p o d g o l o v k a
p o d g o l o s o k	p o d g o l o s k a
p o d g o l o s o k	p o d g o l o s k a
p o d g rj i f o k	p o d g rj i f k a
p o d g r u z d o k	p o d g r u z d k a
p o d d o n o k	p o d d o n k a
p o d d u bj e nj	p o d d u b nj a
p o d z a g o l o v o k	p o d z a g o l o v k a
p o d z a t i l o k	p o d z a t i l k a
p o d zj o m o k	p o d zj o m k a
p o d z o b o k	p o d z o b k a
p o d k lj i n o k	p o d k lj i n k a
p o d k o s o k	p o d k o s k a
p o d k r i l o k	p o d k r i l k a
p o d l a v o k	p o d l a v k a
p o d lj e s o k	p o d lj e s k a
p o d lj i s o k	p o d lj i s k a
p o d m a lj o v o k	p o d m a lj o v k a
p o d n a j o m	p o d n a j m a
p o d o b a b o k	p o d o b a b k a
p o d o zh o k	p o d o zh k a
p o d o n o k	p o d o n k a
p o d p a s o k	p o d p a s k a
p o d pj e ch e k	p o d pj e ch k a
p o d pj i l o k	p o d pj i l k a
p o d r a m o k	p o d r a m k a
p o d r a n o k	p o d r a n k a
p o d r o s t o k	p o d r o s t k a
p o d s a d o k	p o d s a d k a
p o d s vj i n o k	p o d s vj i n k a
p o d s o s o k	p o d s o s k a
p o d s t a r o k	p o d s t a r k a
p o d s tj e n o k	p o d s tj e n k a
p o d s u d o k	p o d s u d k a
p o d s u m o k	p o d s u m k a
p o d tj o l o k	p o d tj o l k a
p o d t o p o k	p o d t o p k a
p o d x o dj e ts	p o d x o d ts a
p o d ch a l o k	p o d ch a l k a
p o d sh o r s t o k	p o d sh o r s t k a
p o d sh e s t o k	p o d sh e s t k a
p o d j a z o k	p o d j a z k a
p o j e dj i n o k	p o j e dj i n k a
p o j i lj e ts	p o j i lj ts a
p o l dj e nj	p o l d nj a
p o l z o k	p o l z k a
p o l z u n o k	p o l z u n k a
p o l z u n o k	p o l z u n k a
p o lj i t k r u zh o k	p o lj i t k r u zh k a
p o l k o v o dj e ts	p o l k o v o d ts a
p o l o vj e ts	p o l o v ts a
p o l o vj i ch o k	p o l o vj i ch k a
p o l o zh o k	p o l o zh k a
p o l o z o k	p o l o z k a
p o l o k	p o l k a
p o l o t o k	p o l o t k a
p o l t a vj e ts	p o l t a v ts a
p o l tj i n nj i ch e k	p o l tj i n nj i ch k a
p o l u g o d o k	p o l u g o d k a
p o l u d u r o k	p o l u d u r k a
p o l u k o zj o l	p o l u k o z l a
p o l u s t a n o k	p o l u s t a n k a
p o l u sh a l o k	p o l u sh a l k a
p o l u sh u b o k	p o l u sh u b k a
p o l ch o k	p o l ch k a
p o l i n o k	p o l i n k a
p o m a z o k	p o m a z k a
p o mj e r a nj e ts	p o mj e r a n ts a
p o m o lj e ts	p o m o lj ts a
p o m o rj e ts	p o m o r ts a
p o m i sj e l	p o m i s l a
p o pj o n o k	p o pj o n k a
p o p l a v o k	p o p l a v k a
p o p o l zj e nj	p o p o l z nj a
p o r a zh e nj e ts	p o r a zh e n ts a
p o r o zh e k	p o r o zh k a
p o r o sh o k	p o r o sh k a
p o r t rj e tj e ts	p o r t rj e t ts a
p o r t u g a lj e ts	p o r t u g a lj ts a
p o r u ch e nj e ts	p o r u ch e n ts a
p o r u ch e nj	p o r u ch nj a
p o r fj i r o n o sj e ts	p o r fj i r o n o s ts a
p o r sh e nj o k	p o r sh e nj k a
p o r sh e nj	p o r sh nj a
p o r sh e nj	p o r sh nj a
p o rj a d o k	p o rj a d k a
p o rj a d o ch e k	p o rj a d o ch k a
p o sj e lj e nj e ts	p o sj e lj e n ts a
p o sj o l o k	p o sj o l k a
p o s l a nj e ts	p o s l a n ts a
p o s o l	p o s l a
p o s o sh o k	p o s o sh k a
p o s t a vj e ts	p o s t a v ts a
p o s tj e pj e n o vj e ts	p o s tj e pj e n o v ts a
p o s t o j a lj e ts	p o s t o j a lj ts a
p o s t rj i zh e nj e ts	p o s t rj i zh e n ts a
p o s t u p o k	p o s t u p k a
p o t o l o k	p o t o l k a
p o t o m o k	p o t o m k a
p o ch a t o k	p o ch a t k a
p o ch i n o k	p o ch i n k a
p o sh e x o nj e ts	p o sh e x o n ts a
p o j a r o k	p o j a r k a
p o j a s o k	p o j a s k a
p r a v d o lj u bj e ts	p r a v d o lj u b ts a
p r a v lj e nj e ts	p r a v lj e n ts a
p r a v o p o rj a d o k	p r a v o p o rj a d k a
p r a zh e ts	p r a zh ts a
p r a z d nj i ch e k	p r a z d nj i ch k a
p r a o tj e ts	p r a o t ts a
p rj e d k r i l o k	p rj e d k r i l k a
p rj e d o k	p rj e d k a
p rj e d r a s s u d o k	p rj e d r a s s u d k a
p rj e d r o s t o k	p rj e d r o s t k a
p rj e j i z b i t o k	p rj e j i z b i t k a
p rj e s vj i tj e rj i a nj e ts	p rj e s vj i tj e rj i a n ts a
p rj e t o rj i a nj e ts	p rj e t o rj i a n ts a
p rj i b i t o k	p rj i b i t k a
p rj i v a r o k	p rj i v a r k a
p rj i vj e r zh e nj e ts	p rj i vj e r zh e n ts a
p rj i vj e s o k	p rj i vj e s k a
p rj i vj i v o k	p rj i vj i v k a
p rj i g o r o k	p rj i g o r k a
p rj i d a t o k	p rj i d a t k a
p rj i l a v o k	p rj i l a v k a
p rj i mj i rj e nj e ts	p rj i mj i rj e n ts a
p rj i p a d o k	p rj i p a d k a
p rj i pj e r tj e nj	p rj i pj e r t nj a
p rj i r a b o t o k	p rj i r a b o t k a
p rj i rj e z o k	p rj i rj e z k a
p rj i r o s t o k	p rj i r o s t k a
p rj i s a d o k	p rj i s a d k a
p rj i sj o l o k	p rj i sj o l k a
p rj i s o s o k	p rj i s o s k a
p rj i s p o s o b lj e nj e ts	p rj i s p o s o b lj e n ts a
p rj i s t u p o k	p rj i s t u p k a
p rj i x v o s tj e nj	p rj i x v o s t nj a
p rj i ch a l o k	p rj i ch a l k a
p rj i sh e lj e ts	p rj i sh e lj ts a
p rj i j a m o k	p rj i j a m k a
p r o vj i dj e ts	p r o vj i d ts a
p r o g a l o k	p r o g a l k a
p r o d a vj e ts	p r o d a v ts a
p r o zh i l o k	p r o zh i l k a
p r o zh i t o k	p r o zh i t k a
p r o z o r lj i vj e ts	p r o z o r lj i v ts a
p r o lj e zh e nj	p r o lj e zh nj a
p r o lj e s o k	p r o lj e s k a
p r o lj i vj e nj	p r o lj i v nj a
p r o mj e zh u t o k	p r o mj e zh u t k a
p r o m i sj e l	p r o m i s l a
p r o r o s t o k	p r o r o s t k a
p r o s vj e shshj e nj e ts	p r o s vj e shshj e n ts a
p r o sj o l o k	p r o sj o l k a
p r o s l o j e k	p r o s l o j k a
p r o s t a ch o k	p r o s t a ch k a
p r o s tj e n o k	p r o s tj e n k a
p r o s t u p o k	p r o s t u p k a
p r o tj i vj e nj	p r o tj i v nj a
p r o t u bj e r a nj e ts	p r o t u bj e r a n ts a
p r o u l o k	p r o u l k a
p r o x l a dj e ts	p r o x l a d ts a
p r o x o dj i mj e ts	p r o x o dj i m ts a
p r o sh i vj e nj	p r o sh i v nj a
p r u d o k	p r u d k a
p r u zh o k	p r u zh k a
p r u t o k	p r u t k a
p r i zh o k	p r i zh k a
p rj a zh e nj e ts	p rj a zh e n ts a
p rj a nj i ch e k	p rj a nj i ch k a
p s a l m o pj e vj e ts	p s a l m o pj e v ts a
p s a l o m	p s a l m a
p tj e nj e ts	p tj e n ts a
p u z a n o k	p u z a n k a
p u z i rj o k	p u z i rj k a
p u z i rj o ch e k	p u z i rj o ch k a
p u p o k	p u p k a
p u p o ch e k	p u p o ch k a
p u p i r i sh e k	p u p i r i sh k a
p u s tj a ch o k	p u s tj a ch k a
p u tj e j e ts	p u tj e j ts a
p u tj e ts	p u t ts a
p u x o vj i ch o k	p u x o vj i ch k a
p u ch o k	p u ch k a
p u ch o ch e k	p u ch o ch k a
p u sh o k	p u sh k a
pj a t a ch o k	pj a t a ch k a
pj a tj i b o rj e ts	pj a tj i b o r ts a
pj a t o k	pj a t k a
pj a t o ch e k	pj a t o ch k a
r a b o v l a dj e lj e ts	r a b o v l a dj e lj ts a
r a b o t nj i ch e k	r a b o t nj i ch k a
r a b o t o r g o vj e ts	r a b o t o r g o v ts a
r a b f a k o vj e ts	r a b f a k o v ts a
r a dj i o u zj e l	r a dj i o u z l a
r a j o k	r a j k a
r a z v a lj e ts	r a z v a lj ts a
r a z vj e dj e nj e ts	r a z vj e dj e n ts a
r a z vj i l o k	r a z vj i l k a
r a z l o zh e nj e ts	r a z l o zh e n ts a
r a z n o vj e s o k	r a z n o vj e s k a
r a z n o ch i nj e ts	r a z n o ch i n ts a
r a z o k	r a z k a
r a z o ch e k	r a z o ch k a
r a j k o m o vj e ts	r a j k o m o v ts a
r a kj e t o n o sj e ts	r a kj e t o n o s ts a
r a nj e ts	r a n ts a
r a s k r a s a vj e ts	r a s k r a s a v ts a
r a s p a d o k	r a s p a d k a
r a s p o rj a d o k	r a s p o rj a d k a
r a s s k a zj e ts	r a s s k a z ts a
r a s s u d o k	r a s s u d k a
r a s ts e n o k	r a s ts e n k a
r a t o b o rj e ts	r a t o b o r ts a
r a ch o k	r a ch k a
rj e bj a tj o n o k	rj e bj a tj o n k a
rj e v nj i vj e ts	rj e v nj i v ts a
rj e z a ch o k	rj e z a ch k a
rj e zj e ts	rj e z ts a
rj e mj e nj	rj e m nj a
rj e mj e sh o k	rj e mj e sh k a
rj e pj e j o k	rj e pj e j k a
rj e pj e j	rj e pj j a
rj e s p u b lj i k a nj e ts	rj e s p u b lj i k a n ts a
rj e t o r o m a nj e ts	rj e t o r o m a n ts a
r zh a nj e ts	r zh a n ts a
rj i s u n o k	rj i s u n k a
rj i s u n o ch e k	rj i s u n o ch k a
r o g o n o sj e ts	r o g o n o s ts a
r o dj i mj e ts	r o dj i m ts a
r o d nj i ch o k	r o d nj i ch k a
r o d o s l o vj e ts	r o d o s l o v ts a
r o d s t vj e n nj i ch e k	r o d s t vj e n nj i ch k a
r o j o k	r o j k a
r o zh o k	r o zh k a
r o zh o n	r o zh n a
r o z lj i vj e nj	r o z lj i v nj a
r o s t o k	r o s t k a
r o t	r t a
r o t o k	r o t k a
r u b a n o k	r u b a n k a
r u bj e ts	r u b ts a
r u d o z n a tj e ts	r u d o z n a t ts a
r u mj a nj e ts	r u mj a n ts a
r u nj e ts	r u n ts a
r u s a ch o k	r u s a ch k a
r u ch e j o k	r u ch e j k a
r u ch e j	r u ch j a
r i bj e ts	r i b ts a
r i b o t o r g o vj e ts	r i b o t o r g o v ts a
r i v o k	r i v k a
r i d a lj e ts	r i d a lj ts a
r i n o k	r i n k a
r i s a ch o k	r i s a ch k a
r i ch a zh o k	r i ch a zh k a
rj u k z a ch o k	rj u k z a ch k a
rj a b o k	rj a b k a
rj a d o k	rj a d k a
rj a d o ch e k	rj a d o ch k a
s a d o v l a dj e lj e ts	s a d o v l a dj e lj ts a
s a d o k	s a d k a
s a j o k	s a j k a
s a j o k	s a j k a
s a zh e nj e ts	s a zh e n ts a
s a k s o nj e ts	s a k s o n ts a
s a mj e ts	s a m ts a
s a m o vj i dj e ts	s a m o vj i d ts a
s a m o dj e r zh e ts	s a m o dj e r zh ts a
s a m o z v a nj e ts	s a m o z v a n ts a
s a m o lj u bj e ts	s a m o lj u b ts a
s a m o pj i sj e ts	s a m o pj i s ts a
s a m o r o d o k	s a m o r o d k a
s a m o r o d o k	s a m o r o d k a
s a m o u p r a vj e ts	s a m o u p r a v ts a
s a n u zj e l	s a n u z l a
s a p o zh o k	s a p o zh k a
s a ch o k	s a ch k a
s v a j e b o j e ts	s v a j e b o j ts a
s v a r lj i vj e ts	s v a r lj i v ts a
s v a t o k	s v a t k a
s vj e dj e nj e ts	s vj e dj e n ts a
s vj o k o r	s vj o k r a
s vj o r t o k	s vj o r t k a
s vj o r t o ch e k	s vj o r t o ch k a
s vj e r ch o k	s vj e r ch k a
s vj e tj e ts	s vj e t ts a
s vj e t lj a ch o k	s vj e t lj a ch k a
s vj e shshj e n o sj e ts	s vj e shshj e n o s ts a
s vj i nj e ts	s vj i n ts a
s vj i n o b o j e ts	s vj i n o b o j ts a
s vj i r o k	s vj i r k a
s vj i s t o k	s vj i s t k a
s vj i s t o ch e k	s vj i s t o ch k a
s vj i s t u n o k	s vj i s t u n k a
s vj i t o k	s vj i t k a
s v o b o d o lj u bj e ts	s v o b o d o lj u b ts a
s v o j e zj e mj e ts	s v o j e zj e m ts a
s vj a t o t a tj e ts	s vj a t o t a t ts a
s g nj o t o k	s g nj o t k a
s g u s t o k	s g u s t k a
sj e bj a lj u bj e ts	sj e bj a lj u b ts a
sj e vj e r o a mj e rj i k a nj e ts	sj e vj e r o a mj e rj i k a n ts a
sj e vj e r o m o rj e ts	sj e vj e r o m o r ts a
sj e vj e ts	sj e v ts a
sj e v o k	sj e v k a
sj e g o lj e t o k	sj e g o lj e t k a
sj e k rj e tj e ts	sj e k rj e t ts a
sj e lj e zj e nj	sj e lj e z nj a
sj e mj a n o sj e ts	sj e mj a n o s ts a
sj e nj e g a lj e ts	sj e nj e g a lj ts a
sj e n o s t a vj e ts	sj e n o s t a v ts a
sj e r d ts e vj e dj e ts	sj e r d ts e vj e d ts a
sj e rj e d nj a ch o k	sj e rj e d nj a ch k a
sj e rj a ch o k	sj e rj a ch k a
sj e j a nj e ts	sj e j a n ts a
sj i bj i rj e ts	sj i bj i r ts a
sj i dj e lj e ts	sj i dj e lj ts a
sj i dj e nj	sj i d nj a
sj i zh o k	sj i zh k a
sj i l o k	sj i l k a
sj i n g a lj e ts	sj i n g a lj ts a
sj i nj e ts	sj i n ts a
sj i rj i j e ts	sj i rj i j ts a
s k a k u n o k	s k a k u n k a
s k a nj e ts	s k a n ts a
s k a ch o k	s k a ch k a
s k vj e r n a vj e ts	s k vj e r n a v ts a
s k vj e r n o s l o vj e ts	s k vj e r n o s l o v ts a
s k v o z nj a ch o k	s k v o z nj a ch k a
s k v o rj e ts	s k v o r ts a
s kj i t a lj e ts	s kj i t a lj ts a
s k l a dj e nj	s k l a d nj a
s k lj i z o k	s k lj i z k a
s k o v o r o dj e nj	s k o v o r o d nj a
s k o l o k	s k o l k a
s k o pj e ts	s k o p ts a
s k o r o pj i sj e ts	s k o r o pj i s ts a
s k o r o x o dj e ts	s k o r o x o d ts a
s k o s o k	s k o s k a
s k o t o b o j e ts	s k o t o b o j ts a
s k o t o l o zh e ts	s k o t o l o zh ts a
s k o t o t o r g o vj e ts	s k o t o t o r g o v ts a
s k rj e bj e nj	s k rj e b nj a
s k rj e b o k	s k rj e b k a
s k u pj e ts	s k u p ts a
s l a v o lj u bj e ts	s l a v o lj u b ts a
s l a d k o pj e vj e ts	s l a d k o pj e v ts a
s l a nj e ts	s l a n ts a
s l a s t o lj u bj e ts	s l a s t o lj u b ts a
s lj e d o k	s lj e d k a
s lj e pj e nj	s lj e p nj a
s lj e pj e ts	s lj e p ts a
s lj e p o k	s lj e p k a
s lj o t o k	s lj o t k a
s lj i zj e nj	s lj i z nj a
s lj i t o k	s lj i t k a
s l o vj e nj e ts	s l o vj e n ts a
s l o vj i nj e ts	s l o vj i n ts a
s l o pj e ts	s l o p ts a
s l u sh o k	s l u sh k a
s mj e n o vj e x o vj e ts	s mj e n o vj e x o v ts a
s mj e sh o k	s mj e sh k a
s m o r ch o k	s m o r ch k a
s m o r ch o k	s m o r ch k a
s m u sh e k	s m u sh k a
s m i ch o k	s m i ch k a
s n a b zh e nj e ts	s n a b zh e n ts a
s nj e t o k	s nj e t k a
s nj i m o k	s nj i m k a
s n o vj i dj e ts	s n o vj i d ts a
s o v l a dj e lj e ts	s o v l a dj e lj ts a
s o v o k	s o v k a
s o v o ch e k	s o v o ch k a
s o j i s tj e ts	s o j i s t ts a
s o k o l o k	s o k o l k a
s o k o l o k	s o k o l k a
s o lj e p r o m i sj e l	s o lj e p r o m i s l a
s o l o vj e j	s o l o vj j a
s o l o v u sh e k	s o l o v u sh k a
s o l o nj e ts	s o l o n ts a
s o m a lj i j e ts	s o m a lj i j ts a
s o n	s n a
s o n lj i vj e ts	s o n lj i v ts a
s o p lj i vj e ts	s o p lj i v ts a
s o p r o tj i v lj e nj e ts	s o p r o tj i v lj e n ts a
s o r v a nj e ts	s o r v a n ts a
s o sj e ts	s o s ts a
s o s l u zh i vj e ts	s o s l u zh i v ts a
s o s nj a ch o k	s o s nj a ch k a
s o s o k	s o s k a
s o s o ch e k	s o s o ch k a
s o s u n o k	s o s u n k a
s o ch e nj	s o ch nj a
s o ch i nj e ts	s o ch i n ts a
s p a r t a k o vj e ts	s p a r t a k o v ts a
s p a r t a nj e ts	s p a r t a n ts a
s pj e sj i vj e ts	s pj e sj i v ts a
s pj i l o k	s pj i l k a
s pj i s o k	s pj i s k a
s pj i s o ch e k	s pj i s o ch k a
s p l o t o k	s p l o t k a
s p o r o k	s p o r k a
s p r a vj e d lj i vj e ts	s p r a vj e d lj i v ts a
s rj e b r o lj u bj e ts	s rj e b r o lj u b ts a
s rj e z o k	s rj e z k a
s r o s t o k	s r o s t k a
s s i lj n o p o sj e lj e nj e ts	s s i lj n o p o sj e lj e n ts a
s t a vj e nj	s t a v nj a
s t a vj e ts	s t a v ts a
s t a vj e sh e k	s t a vj e sh k a
s t a v o k	s t a v k a
s t a n o k	s t a n k a
s t a n o ch e k	s t a n o ch k a
s t a rj e ts	s t a r ts a
s t a rj i ch o k	s t a rj i ch k a
s t a r o vj e rj e ts	s t a r o vj e r ts a
s t a r o o b rj a dj e ts	s t a r o o b rj a d ts a
s t a x a n o vj e ts	s t a x a n o v ts a
s tj e bj e lj o k	s tj e bj e lj k a
s tj e bj e lj	s tj e b lj a
s tj e bj e lj	s tj e b lj a
s tj e zh o k	s tj e zh k a
s tj e n o pj i sj e ts	s tj e n o pj i s ts a
s tj e r zh e nj o k	s tj e r zh e nj k a
s tj e r zh e nj	s tj e r zh nj a
s tj e r zh e nj	s tj e r zh nj a
s tj i x o t v o rj e ts	s tj i x o t v o r ts a
s tj i sh o k	s tj i sh k a
s t l a nj e ts	s t l a n ts a
s t o zh o k	s t o zh k a
s t o l bj e ts	s t o l b ts a
s t o r o zh o k	s t o r o zh k a
s t o j a lj e ts	s t o j a lj ts a
s t o j a ch o k	s t o j a ch k a
s t r a d a lj e ts	s t r a d a lj ts a
s t r a n n o lj u bj e ts	s t r a n n o lj u b ts a
s t r a n n o p rj i j i mj e ts	s t r a n n o p rj i j i m ts a
s t r a s t o tj e r pj e ts	s t r a s t o tj e r p ts a
s t rj e zh e nj	s t rj e zh nj a
s t rj e lj e ts	s t rj e lj ts a
s t rj e l o vj e r zh e ts	s t rj e l o vj e r zh ts a
s t rj e l o k	s t rj e l k a
s t rj e ch o k	s t rj e ch k a
s t rj i g u nj e ts	s t rj i g u n ts a
s t rj i g u n o k	s t rj i g u n k a
s t r o p tj i vj e ts	s t r o p tj i v ts a
s t r o ch o k	s t r o ch k a
s t r u nj e ts	s t r u n ts a
s t r u ch o k	s t r u ch k a
s t u dj e nj	s t u d nj a
s t u dj i j e ts	s t u dj i j ts a
s t i d lj i vj e ts	s t i d lj i v ts a
s u v o r o vj e ts	s u v o r o v ts a
s u g lj i n o k	s u g lj i n k a
s u d a nj e ts	s u d a n ts a
s u d a ch o k	s u d a ch k a
s u dj e j e ts	s u dj e j ts a
s u d o v l a dj e lj e ts	s u d o v l a dj e lj ts a
s u d o k	s u d k a
s u d o x o dj e ts	s u d o x o d ts a
s u d o ch e k	s u d o ch k a
s u n d u ch o k	s u n d u ch k a
s u pj e s o k	s u pj e s k a
s u r o k	s u r k a
s u x o j a dj e ts	s u x o j a d ts a
s u ch o k	s u ch k a
s u ch o ch e k	s u ch o ch k a
s ch a s t lj i vj e ts	s ch a s t lj i v ts a
s ch o tj e ts	s ch o t ts a
s j e z d o vj e ts	s j e z d o v ts a
s i n o k	s i n k a
s i n o ch e k	s i n o ch k a
s i pj e ts	s i p ts a
s i rj e ts	s i r ts a
s i r o vj e ts	s i r o v ts a
s i r o k	s i r k a
s i ch u zh o k	s i ch u zh k a
sj u zh e tj e ts	sj u zh e t ts a
sj u r p rj i zj e ts	sj u r p rj i z ts a
sj u r t u ch o k	sj u r t u ch k a
sj a zh o k	sj a zh k a
t a b a s a r a nj e ts	t a b a s a r a n ts a
t a b u n o k	t a b u n k a
t a g a nj e ts	t a g a n ts a
t a g a n o k	t a g a n k a
t a j i l a n dj e ts	t a j i l a n d ts a
t a j nj i ch o k	t a j nj i ch k a
t a nj e ts	t a n ts a
t a n z a nj i j e ts	t a n z a nj i j ts a
t v o rj e ts	t v o r ts a
tj e bj e nj o k	tj e bj e nj k a
tj e kj i nj e ts	tj e kj i n ts a
tj e lj e pj e nj	tj e lj e p nj a
tj e lj e pj e nj	tj e lj e p nj a
tj e lj e ts	tj e lj ts a
tj e l o k	tj e l k a
tj e nj o k	tj e nj k a
tj e nj o ch e k	tj e nj o ch k a
tj e n o r o k	tj e n o r k a
tj e rj e m o k	tj e rj e m k a
tj e rj e m o ch e k	tj e rj e m o ch k a
tj e rj e ts	tj e r ts a
tj e r mj i d o rj i a nj e ts	tj e r mj i d o rj i a n ts a
tj e s a ch o k	tj e s a ch k a
tj i bj e tj e ts	tj i bj e t ts a
tj i vj e rj e ts	tj i vj e r ts a
tj i gj e lj o k	tj i gj e lj k a
tj i gj e lj	tj i g lj a
tj i m u r o vj e ts	tj i m u r o v ts a
tj i pj e ts	tj i p ts a
tj i r a n o b o rj e ts	tj i r a n o b o r ts a
tj i x o o kj e a nj e ts	tj i x o o kj e a n ts a
t o v a r o v l a dj e lj e ts	t o v a r o v l a dj e lj ts a
t o g o lj e zj e ts	t o g o lj e z ts a
t o l s t o vj e ts	t o l s t o v ts a
t o l s tj a ch o k	t o l s tj a ch k a
t o l ch o k	t o l ch k a
t o p o lj o k	t o p o lj k a
t o r g o vj e ts	t o r g o v ts a
t o rj e ts	t o r ts a
t o r pj e d o vj e ts	t o r pj e d o v ts a
t o r pj e d o n o sj e ts	t o r pj e d o n o s ts a
t o r ch o k	t o r ch k a
t r a nj e ts	t r a n ts a
t rj e z u bj e ts	t rj e z u b ts a
t rj e pj e ts	t rj e p ts a
t rj o x lj e t o k	t rj o x lj e t k a
t r o j e zh e nj e ts	t r o j e zh e n ts a
t r o j a ch o k	t r o j a ch k a
t r u d o dj e nj	t r u d o d nj a
t r u d o lj u bj e ts	t r u d o lj u b ts a
t r u tj e nj	t r u t nj a
t u vj i nj e ts	t u vj i n ts a
t u j e s o k	t u j e s k a
t u zj e mj e ts	t u zj e m ts a
t u nj e ts	t u n ts a
t u nj e j a dj e ts	t u nj e j a d ts a
t u nj i sj e ts	t u nj i s ts a
t u pj e ts	t u p ts a
t u pj i ch o k	t u pj i ch k a
t u p o u m o k	t u p o u m k a
t i n o k	t i n k a
t i ch o k	t i ch k a
tj u lj e nj e b o j e ts	tj u lj e nj e b o j ts a
tj u fj a ch o k	tj u fj a ch k a
tj u ch o k	tj u ch k a
u b lj u d o k	u b lj u d k a
u v a lj e nj	u v a lj nj a
u g o l o ch e k	u g o l o ch k a
u g o lj	u g lj a
u g o lj	u g lj a
u g o lj	u g lj a
u g o rj o k	u g o rj k a
u g o rj	u g rj a
u g o rj	u g rj a
u d a lj e ts	u d a lj ts a
u d e gj e j e ts	u d e gj e j ts a
u zj e l	u z l a
u zj e l o k	u zj e l k a
u zj e l o ch e k	u zj e l o ch k a
u k r a j i nj e ts	u k r a j i n ts a
u lj e j	u lj j a
u mj e lj e ts	u mj e lj ts a
u m i sj e l	u m i s l a
u p a d o k	u p a d k a
u p r a v lj e nj e ts	u p r a v lj e n ts a
u p r o shshj e nj e ts	u p r o shshj e n ts a
u p rj a mj e ts	u p rj a m ts a
u r a v nj i l o vj e ts	u r a v nj i l o v ts a
u r a lj e ts	u r a lj ts a
u r o vj e nj	u r o v nj a
u r o dj e ts	u r o d ts a
u r u g v a j e ts	u r u g v a j ts a
u rj a n x a j e ts	u rj a n x a j ts a
u s t a t o k	u s t a t k a
u t o k	u t k a
u tj u zh o k	u tj u zh k a
u ch a s t o k	u ch a s t k a
u ch a s t o ch e k	u ch a s t o ch k a
u ch tj i vj e ts	u ch tj i v ts a
f a bj i a nj e ts	f a bj i a n ts a
f a r t u ch e k	f a r t u ch k a
fj e j j e r b a xj i a nj e ts	fj e j j e r b a xj i a n ts a
fj e r r o m a r g a nj e ts	fj e r r o m a r g a n ts a
fj i lj i p pj i nj e ts	fj i lj i p pj i n ts a
fj i nj i kj i j e ts	fj i nj i kj i j ts a
fj i n lj a n dj e ts	fj i n lj a n d ts a
fj i tj i lj o k	fj i tj i lj k a
fj i x tj e a nj e ts	fj i x tj e a n ts a
f l a zh o k	f l a zh k a
f l a m a n dj e ts	f l a m a n d ts a
f l a nj e ts	f l a n ts a
f lj i gj e lj o k	f lj i gj e lj k a
f l o t o v o dj e ts	f l o t o v o d ts a
f o r sh tj e vj e nj	f o r sh tj e v nj a
f o t o o t pj e ch a t o k	f o t o o t pj e ch a t k a
f o t o s nj i m o k	f o t o s nj i m k a
f r a kj i j e ts	f r a kj i j ts a
f r a n ts i s k a nj e ts	f r a n ts i s k a n ts a
f rj i gj i j e ts	f rj i gj i j ts a
f u g a n o k	f u g a n k a
f i r o k	f i r k a
x a r a k tj e rj e ts	x a r a k tj e r ts a
x v o s tj e ts	x v o s t ts a
xj i vj i nj e ts	xj i vj i n ts a
x lj e bj e ts	x lj e b ts a
x lj e b o k	x lj e b k a
x lj e b o p a sh e ts	x lj e b o p a sh ts a
x lj e b o t o r g o vj e ts	x lj e b o t o r g o v ts a
x lj e b u sh e k	x lj e b u sh k a
x lj e v o k	x lj e v k a
x lj e v u sh o k	x lj e v u sh k a
x l o pj e ts	x l o p ts a
x l o p o k	x l o p k a
x l o p o k	x l o p k a
x l o p u nj e ts	x l o p u n ts a
x o b o t o k	x o b o t k a
x o dj e nj	x o d nj a
x o d o k	x o d k a
x o l m o k	x o l m k a
x o m u t o k	x o m u t k a
x o mj a ch o k	x o mj a ch k a
x o rj o k	x o rj k a
x o r u g vj e n o sj e ts	x o r u g vj e n o s ts a
x o x o l	x o x l a
x o x o l	x o x l a
x o x o l o k	x o x o l k a
x o x o l o ch e k	x o x o l o ch k a
x o x o t o k	x o x o t k a
x r a p o k	x r a p k a
x rj e bj e t	x rj e b t a
x rj i s t o p r o d a vj e ts	x rj i s t o p r o d a v ts a
x r o mj e ts	x r o m ts a
x rj a ch o k	x rj a ch k a
x u t o r o k	x u t o r k a
ts a rj e d v o rj e ts	ts a rj e d v o r ts a
ts a rj o k	ts a rj k a
ts vj e tj e nj	ts vj e t nj a
ts vj e t o k	ts vj e t k a
ts vj e t o ch e k	ts vj e t o ch k a
ts e j l o nj e ts	ts e j l o n ts a
ts e pj e nj	ts e p nj a
ch a bj o r	ch a b r a
ch a j nj i ch e k	ch a j nj i ch k a
ch a s o k	ch a s k a
ch a s o ch e k	ch a s o ch k a
ch e l n o ch o k	ch e l n o ch k a
ch e l o vj e k o dj e nj	ch e l o vj e k o d nj a
ch e l o vj e k o lj u bj e ts	ch e l o vj e k o lj u b ts a
ch e l o vj e ch e k	ch e l o vj e ch k a
ch e lj a dj i nj e ts	ch e lj a dj i n ts a
ch e pj e ts	ch e p ts a
ch e r vj e ts	ch e r v ts a
ch e r v o nj e ts	ch e r v o n ts a
ch e r vj a ch o k	ch e r vj a ch k a
ch e r d a ch o k	ch e r d a ch k a
ch e rj e n o k	ch e rj e n k a
ch e rj e n o k	ch e rj e n k a
ch e rj e p o k	ch e rj e p k a
ch e rj e sh o k	ch e rj e sh k a
ch e r n o g o rj e ts	ch e r n o g o r ts a
ch e r n o k o rj e nj	ch e r n o k o r nj a
ch e r n o m o rj e ts	ch e r n o m o r ts a
ch e r n o rj i zj e ts	ch e r n o rj i z ts a
ch e r n o s o tj e nj e ts	ch e r n o s o tj e n ts a
ch e r p a ch o k	ch e r p a ch k a
ch e s t o lj u bj e ts	ch e s t o lj u b ts a
ch e t vj e r t o k	ch e t vj e r t k a
ch e t i rj o x lj e t o k	ch e t i rj o x lj e t k a
ch e x o l	ch e x l a
ch e ch e nj e ts	ch e ch e n ts a
ch i lj i j e ts	ch i lj i j ts a
ch i rj e j	ch i rj j a
ch i r o k	ch i r k a
ch u g u n o k	ch u g u n k a
ch u d o t v o rj e ts	ch u d o t v o r ts a
ch u zh e zj e mj e ts	ch u zh e zj e m ts a
ch u zh e s t r a nj e ts	ch u zh e s t r a n ts a
ch u r b a ch o k	ch u r b a ch k a
ch u x o nj e ts	ch u x o n ts a
sh a bj o r	sh a b r a
sh a zh o k	sh a zh k a
sh a zh o ch e k	sh a zh o ch k a
sh a nj e ts	sh a n ts a
sh a tj o r	sh a t r a
sh a x t o v l a dj e lj e ts	sh a x t o v l a dj e lj ts a
sh a sh e nj	sh a sh nj a
sh vj e j ts a rj e ts	sh vj e j ts a r ts a
sh v i r o k	sh v i r k a
sh e l lj i n gj i a nj e ts	sh e l lj i n gj i a n ts a
sh e p o t o k	sh e p o t k a
sh e r sh e nj	sh e r sh nj a
sh e s t o k	sh e s t k a
sh i n o k	sh i n k a
sh k v o rj e nj	sh k v o r nj a
sh lj o p a nj e ts	sh lj o p a n ts a
sh lj e p o k	sh lj e p k a
sh l i ch o k	sh l i ch k a
sh m a t o k	sh m a t k a
sh n u r o k	sh n u r k a
sh o rj e ts	sh o r ts a
sh o t l a n dj e ts	sh o t l a n d ts a
sh pj e nj o k	sh pj e nj k a
sh p o rj e ts	sh p o r ts a
sh tj e vj e nj	sh tj e v nj a
sh t rj i sh o k	sh t rj i sh k a
sh t i rj o k	sh t i rj k a
sh u m o k	sh u m k a
shshj e g o l	shshj e g l a
shshj e l ch o k	shshj e l ch k a
shshj i pj e ts	shshj i p ts a
shshj i p o k	shshj i p k a
shshj i tj e nj	shshj i t nj a
shshj i t o k	shshj i t k a
shshj i t o n o sj e ts	shshj i t o n o s ts a
shshj u r o k	shshj u r k a
e k v a d o rj e ts	e k v a d o r ts a
e lj e k t r o d vj i zh o k	e lj e k t r o d vj i zh k a
e lj z a sj e ts	e lj z a s ts a
e pj i z o dj e ts	e pj i z o d ts a
e pj i k u rj e j e ts	e pj i k u rj e j ts a
e s mj i nj e ts	e s mj i n ts a
e s t o nj e ts	e s t o n ts a
e s e s o vj e ts	e s e s o v ts a
j u zh n o a mj e rj i k a nj e ts	j u zh n o a mj e rj i k a n ts a
j u m o r o k	j u m o r k a
j u nj e ts	j u n ts a
j u r o k	j u r k a
j a v a nj e ts	j a v a n ts a
j a z i k o t v o rj e ts	j a z i k o t v o r ts a
j a z i ch o k	j a z i ch k a
j a k o bj i nj e ts	j a k o bj i n ts a
j a k o rj o k	j a k o rj k a
j a l tj i nj e ts	j a l tj i n ts a
j a p o nj e ts	j a p o n ts a
j a r l i ch o k	j a r l i ch k a
j a r o k	j a r k a
j a r u n o k	j a r u n k a
j a sj e nj e ts	j a sj e n ts a
j a s n o vj i dj e ts	j a s n o vj i d ts a
j a s t rj e b o k	j a s t rj e b k a
j a shshj i ch e k	j a shshj i ch k a
b a l i ch o k	b a l i ch k a
bj e rj e zh o k	bj e rj e zh k a
bj e s p o rj a d o k	bj e s p o rj a d k a
b o ch o k	b o ch k a
vj e tj e r	vj e t r a
vj e tj e r	vj e t r a
g o r o sh e k	g o r o sh k a
dj e g o t o k	dj e g o t k a
dj o g o tj	dj o g tj a
d i m o k	d i m k a
zh a r o k	zh a r k a
zh i r o k	zh i r k a
k v a s o k	k v a s k a
kj i pj a t o k	kj i pj a t k a
kj i sj e lj o k	kj i sj e lj k a
k o nj j a ch o k	k o nj j a ch k a
k o fj e j o k	k o fj e j k a
l a ch o k	l a ch k a
lj e d o k	lj e d k a
lj o n	lj n a
lj e n o k	lj e n k a
lj i kj o rj e ts	lj i kj o r ts a
lj i sh e k	lj i sh k a
l o b	l b a
l u zh o k	l u zh k a
l u ch o k	l u ch k a
m a ch o k	m a ch k a
mj e d o k	mj e d k a
mj e l o k	mj e l k a
p a r o k	p a r k a
pj e pj e l	pj e p l a
pj e r v a ch o k	pj e r v a ch k a
pj e rj e ts	pj e r ts a
pj e s o k	pj e s k a
pj e s o ch e k	pj e s o ch k a
r o t	r t a
s a x a r o k	s a x a r k a
s bj i tj e nj	s bj i t nj a
sj i tj e ts	sj i t ts a
sj i t nj i ch e k	sj i t nj i ch k a
s m a lj e ts	s m a lj ts a
s nj e zh o k	s nj e zh k a
s nj e zh o ch e k	s nj e zh o ch k a
s o ch o k	s o ch k a
s u pj e ts	s u p ts a
s i r o k	s i r k a
t a b a ch o k	t a b a ch k a
t v o r o zh o k	t v o r o zh k a
u b i t o k	u b i t k a
u g o l	u g l a
u g o lj o k	u g o lj k a
u g o l o k	u g o l k a
x mj e lj o k	x mj e lj k a
x o l o dj e ts	x o l o d ts a
x o l o d o k	x o l o d k a
x rj e n o k	x rj e n k a
ch a j o k	ch a j k a
ch e rj e vj i ch e k	ch e rj e vj i ch k a
ch e s n o ch o k	ch e s n o ch k a
sh a sh l i ch o k	sh a sh l i ch k a
shshj e bj e nj	shshj e b nj a
lj o d	lj d a
m o x	m x a
r o v	r v a
