d e x	d e x
k e d	k e d
e N k o n t r	e N k q n t r
p e n s	p y n s
k o n t	k q n t
e n t r	e n t r
t o m	t o m
k r e	k r e
e m p e s	e m p y s
e s p e r	e s p e r
r e k o r d	r e k q r d
k o n s i d e r	k o n s i d e r
k o m e n s	k o m y n s
p r e s e n t	p r e s e n t
s e n t	s y n t
i n t e n t	i n t e n t
f o r m	f o r m
l o g r	l o g r
e C	e C
m o s t r	m q s t r
d e m o s t r	d e m q s t r
a s e p t	a s e p t
a s e r k	a s e r k
s e r r	s y r r
o b s e r b	o b s e r b
t o k	t o k
a b a n d o n	a b a n d o n
p r o b o k	p r o b o k
d e s e	d e s e
d e s a r r o j	d e s a r r o j
k o n t e m p l	k o n t e m p l
r e p r e s e n t	r e p r e s e n t
n e g	n y g
k o m p r	k o m p r
d e s p e r t	d e s p y r t
k o m e n t	k o m e n t
k o m p r o b	k o m p r q b
r e g r e s	r e g r e s
k o n t e s t	k o n t e s t
k o l o k	k o l o k
i m p o r t	i m p o r t
a w m e n t	a w m e n t
r o d e	r o d e
i n t e r e s	i n t e r e s
a p o j	a p o j
s o l	s q l
j o r	j o r
e n t r e g	e n t r e g
s o n	s q n
s e l e b r	s e l e b r
p l a n t e	p l a n t e
n o t	n o t
e n t e r	e n t e r
e n s e n j	e n s e n j
a l e x	a l e x
k o r t	k o r t
f u n s j o n	f u n s j o n
a p r o b e C	a p r o b e C
i n f o r m	i n f o r m
a k o r d	a k q r d
a f e k t	a f e k t
s u p e r	s u p e r
k o n t r o l	k o n t r o l
r e k u p e r	r e k u p e r
k o n s e r b	k o n s e r b
s o b r	s o b r
k o s t	k q s t
e n f r e n t	e n f r e n t
e n b j	e n b i
m a n i f e s t	m a n i f y s t
o r d e n	o r d e n
e m p l e	e m p l e
e k s p r e s	e k s p r e s
t r a n s f o r m	t r a n s f o r m
n o m b r	n o m b r
k o n f e s	k o n f y s
r e l a s j o n	r e l a s j o n
i g n o r	i g n o r
i n b e n t	i n b e n t
p e s	p e s
a t r a b e s	a t r a b y s
p e g	p e g
p r o p o r s j o n	p r o p o r s j o n
k o l g	k q l g
s o p o r t	s o p o r t
k o b r	k o b r
m o n t	m o n t
a s o m	a s o m
e n s e r r	e n s y r r
p r e s t	p r e s t
k o n d e n	k o n d e n
i N k o r p o r	i N k o r p o r
a d o p t	a d o p t
s o n j	s q n j
e l e b	e l e b
s o l t	s q l t
x e n e r	x e n e r
r e f l e x	r e f l e x
p o d	p o d
i n t e r p r e t	i n t e r p r e t
k o n f j	k o n f i
b e s	b e s
a r r o x	a r r o x
r e s p e t	r e s p e t
p a s e	p a s e
f o r s	f q r s
p e r d o n	p e r d o n
b o l	b q l
d e t e k t	d e t e k t
m e n s j o n	m e n s j o n
a p r e t	a p r y t
g o l p e	g o l p e
b e N g	b e N g
g o s	g o s
m o l e s t	m o l e s t
a l i m e n t	a l i m e n t
i n t e g r	i n t e g r
a p o r t	a p o r t
l i b e r	l i b e r
e k s p e r i m e n t	e k s p e r i m e n t
a p r o b	a p r q b
r o b	r o b
m e s k l	m e s k l
e n a m o r	e n a m o r
a r r e g l	a r r e g l
d o t	d o t
s o s p e C	s o s p e C
o d j	o d j
m e d j	m e d j
k e m	k e m
r e s	r e s
t e m b l	t y m b l
k o n f o r m	k o n f o r m
p e n e t r	p e n e t r
g o b e r n	g o b y r n
k o n s e n t r	k o n s e n t r
a l t e r	a l t e r
e m p e n j	e m p e n j
e f e k t w	e f e k t u
b o r r	b o r r
s e s	s e s
s e n t r	s e n t r
o p t	o p t
e l a b o r	e l a b o r
a g o t	a g o t
k o n b o k	k o n b o k
a k o s t	a k q s t
a s e r t	a s y r t
s e n	s e n
e s f o r s	e s f q r s
d o b l	d o b l
o b r	o b r
e s p a n j o l e	e s p a n j o l e
r e m e d j	r e m e d j
r e a k s j o n	r e a k s j o n
a p r e s j	a p r e s j
b a l o r	b a l o r
a l e g r	a l e g r
k o m p l e t	k o m p l e t
p r o l o N g	p r o l o N g
a g r e g	a g r e g
r o s	r o s
d i f e r e n s j	d i f e r e n s j
r e k o m e n d	r e k o m y n d
l a m e n t	l a m e n t
s u x e t	s u x e t
m a n e x	m a n e x
i N g r e s	i N g r e s
d i s e n j	d i s e n j
k a l e n t	k a l y n t
a b o r d	a b o r d
a k o n s e x	a k o n s e x
f l o t	f l o t
r e s e r b	r e s e r b
t r a n s p o r t	t r a n s p o r t
r e n o b	r e n q b
a p e n	a p e n
a p o s t	a p q s t
k o l a b o r	k o l a b o r
e n t e r r	e n t y r r
b r o t	b r o t
a s o s j	a s o s j
p r o t e s t	p r o t e s t
t r o p e s	t r o p y s
a s e n t	a s y n t
k o n s t	k o n s t
a f r o n t	a f r o n t
i m p r e s j o n	i m p r e s j o n
o t o r g	o t o r g
a s o m b r	a s o m b r
r e s p e k t	r e s p e k t
d e s b j	d e s b i
s o l u s j o n	s o l u s j o n
d e s e N k a d e n	d e s e N k a d e n
s e k	s e k
e s t r e j	e s t r e j
n e g o s j	n e g o s j
a o g	a o g
p r e s e n s j	p r e s e n s j
k o n e k t	k o n e k t
d e b o r	d e b o r
r o d	r q d
p o b l	p q b l
d e s p l e g	d e s p l y g
f r e n	f r e n
k o m p e n s	k o m p e n s
k o n d i s j o n	k o n d i s j o n
e k s a x e r	e k s a x e r
d e s e m p e n j	d e s e m p e n j
p o s	p o s
e b o k	e b o k
a s e n t w	a s e n t u
d e r r o t	d e r r o t
a k o m o d	a k o m o d
e n t r e n	e n t r e n
e k s p l o t	e k s p l o t
i N k r e m e n t	i N k r e m e n t
d e s p r e s j	d e s p r e s j
r e f l e k s j o n	r e f l e k s j o n
e s t r e C	e s t r e C
d e s t r o s	d e s t r o s
a s e l e r	a s e l e r
a o r r	a o r r
a d o r n	a d o r n
b j o l	b j o l
a r g u m e n t	a r g u m e n t
r o g	r q g
k o n s o l	k o n s q l
o k a s j o n	o k a s j o n
r e f o r s	r e f q r s
i d e	i d e
r e m o n t	r e m o n t
C o k	C o k
p e l e	p e l e
s e r k	s e r k
t o r n	t o r n
a d e k w	a d e k u
i n t e r r o g	i n t e r r o g
t r a i s j o n	t r a i s j o n
r e p r o C	r e p r o C
b o l k	b q l k
b e n d	b e n d
e s t r e n	e s t r e n
s o p l	s o p l
k o N k r e t	k o N k r e t
b e l	b e l
a x e n	a x e n
p e k	p e k
e N x e n d r	e N x e n d r
a d e n t r	a d e n t r
d e s b e l	d e s b e l
r e s t	r e s t
e r e d	e r e d
a l b e r g	a l b e r g
e n r e d	e n r e d
o b x e t	o b x e t
a b e r g o n s	a b e r g q n s
p l a n e	p l a n e
e N k a b e s	e N k a b e s
k e b r	k y b r
k o n t e n t	k o n t e n t
r e i t e r	r e i t e r
r a s o n	r a s o n
p o t e n s j	p o t e n s j
a d o r	a d o r
e m o s j o n	e m o s j o n
a l m a s e n	a l m a s e n
d e s b o r d	d e s b o r d
k o p j	k o p j
a s e n d	a s e n d
k o n b e r s	k o n b e r s
e s p j	e s p i
t o p	t o p
k q s t j o n	k q s t j o n
a n o t	a n o t
e b o l u s j o n	e b o l u s j o n
f r o t	f r o t
f o m e n t	f o m e n t
r e k o b r	r e k o b r
p r e s e r b	p r e s e r b
s e l e k s j o n	s e l e k s j o n
d e m o r	d e m o r
d e s e m b o k	d e s e m b o k
k o l	k q l
m o x	m o x
l i b e r t	l i b e r t
b l o k e	b l o k e
s e n t e n s j	s e n t e n s j
b e t	b e t
a f e r r	a f y r r
p e s k	p e s k
k o r o n	k o r o n
t o l e r	t o l e r
e b i d e n s j	e b i d e n s j
n a b e g	n a b e g
r e p o s	r e p o s
s e m b r	s y m b r
k o N x e l	k o N x e l
r o n d	r o n d
e k s p l o r	e k s p l o r
d e s e s p e r	d e s e s p e r
t r e p	t r e p
d e t e r j o r	d e t e r j o r
i n t e r n	i n t e r n
r e b e n t	r e b y n t
a l e g	a l e g
d e s p o x	d e s p o x
a p a r e n t	a p a r e n t
r e k o r t	r e k o r t
d e s k o n s e r t	d e s k o n s y r t
a k o s	a k o s
a l e n t	a l y n t
d e s p e x	d e s p e x
p r e m j	p r e m j
r e k o s t	r e k q s t
e s t r o p e	e s t r o p e
f l o r e	f l o r e
f e C	f e C
d e t e s t	d e t e s t
a t e n t	a t y n t
a n j o r	a n j o r
p r o s e s	p r o s e s
p e r f e k s j o n	p e r f e k s j o n
i m p r e g n	i m p r e g n
a l o x	a l o x
m e n t	m y n t
b o r d e	b o r d e
s u s t e n t	s u s t e n t
e n b e n e n	e n b e n e n
r e s o n	r e s q n
a b o g	a b o g
p r e s j o n	p r e s j o n
o b s e s j o n	o b s e s j o n
d e s p e g	d e s p e g
k o l m	k o l m
f u n d a m e n t	f u n d a m e n t
t e n t	t y n t
a l m o r s	a l m q r s
i n b o k	i n b o k
a l t e r n	a l t e r n
e l	y l
a k a r r e	a k a r r e
s i s t e m	s i s t e m
a t e r r	a t y r r
a p r o p j	a p r o p j
a l e r t	a l e r t
d e s k o l g	d e s k q l g
p r o g r e s	p r o g r e s
r e t o r n	r e t o r n
s e g	s y g
e n t o n	e n t o n
e N g o r d	e N g o r d
a f i s j o n	a f i s j o n
a l i n e	a l i n e
d e s o l	d e s q l
f o r x	f o r x
a m o n t o n	a m o n t o n
u n i f o r m	u n i f o r m
r e k r e	r e k r e
o s t e n t	o s t e n t
s o m b r	s o m b r
e s b o s	e s b o s
t e l e f o n e	t e l e f o n e
o r	o r
e n f o k	e n f o k
e s p o s	e s p o s
d e s k o n f j	d e s k o n f i
s i l e n s j	s i l e n s j
e N k o m e n d	e N k o m y n d
a s e C	a s e C
a k r e s e n t	a k r e s y n t
b r o m e	b r o m e
a f l o x	a f l o x
b o r d	b o r d
s u b l e b	s u b l e b
m a r e	m a r e
s e g r e g	s e g r e g
e n t o r n	e n t o r n
p e l	p e l
d e s e p s j o n	d e s e p s j o n
e s k a l o n	e s k a l o n
r e g	r y g
d e s m o n t	d e s m o n t
m o d e l	m o d e l
a t o r m e n t	a t o r m e n t
s o l d	s q l d
d e k o r	d e k o r
p e n	p e n
b e n e r	b e n e r
e n f r j	e n f r j
d e s e C	d e s e C
d j a l o g	d j a l o g
s a b o r e	s a b o r e
a k s j o n	a k s j o n
p r o s p e r	p r o s p e r
k o m p l e m e n t	k o m p l e m e n t
d e s d e n j	d e s d e n j
a p e l	a p e l
p r e g o n	p r e g o n
d e s m o r o n	d e s m o r o n
t e n s	t e n s
o s	q s
a f l o r	a f l o r
x e s t j o n	x e s t j o n
k o n f e k s j o n	k o n f e k s j o n
a k e x	a k e x
a s e m e x	a s e m e x
f o r r	f o r r
e n d e r e s	e n d e r e s
f r e g	f r y g
r e n e g	r e n y g
s o f o k	s o f o k
a p r e s	a p r e s
s u b e n s j o n	s u b e n s j o n
a p e	a p e
i n s e n d j	i n s e n d j
e l o x j	e l o x j
m o r	m o r
p r e s j	p r e s j
k o n s e r t	k o n s y r t
s a n s j o n	s a n s j o n
l i s e n s j	l i s e n s j
a s e s o r	a s e s o r
r e b o t	r e b o t
d o n	d o n
e n r o j	e n r o j
p a r p a d e	p a r p a d e
p e r p e t w	p e r p e t u
f e s t e x	f e s t e x
i l u s j o n	i l u s j o n
a b o n	a b o n
e m p e o r	e m p e o r
n o b e l	n o b e l
m e	m e
d i s t o r s j o n	d i s t o r s j o n
e s k o l t	e s k o l t
d e s t e r r	d e s t y r r
d e f o r m	d e f o r m
r a s t r e	r a s t r e
d r o g	d r o g
b a l b u s e	b a l b u s e
k o r r o b o r	k o r r o b o r
d i s p e n s	d i s p e n s
b a l a n s e	b a l a n s e
n e b	n y b
s e m e x	s e m e x
r e l e g	r e l e g
d i s p e r s	d i s p e r s
e N g l o b	e N g l o b
t a m b a l e	t a m b a l e
d e p o r t	d e p o r t
n o r m	n o r m
t r a s t o r n	t r a s t o r n
k o l e k s j o n	k o l e k s j o n
s o r t e	s o r t e
d o r	d o r
a s o t	a s o t
d e s i n t e g r	d e s i n t e g r
d o b l e g	d o b l e g
i n s e r t	i n s e r t
o x e	o x e
s o l e	s o l e
e n u m e r	e n u m e r
n u m e r	n u m e r
t e r s j	t e r s j
m o d e r	m o d e r
a k o p l	a k o p l
a r r o p	a r r o p
p e r f o r	p e r f o r
r e k o m p e n s	r e k o m p e n s
p r o m o s j o n	p r o m o s j o n
o b s e k j	o b s e k j
r e s t r e g	r e s t r y g
d e k r e t	d e k r e t
k o N g r e g	k o N g r e g
m e n e	m e n e
a t e n w	a t e n u
a p a s j o n	a p a s j o n
i m p e r	i m p e r
r e m e m o r	r e m e m o r
p r o l i f e r	p r o l i f e r
o n r	o n r
k u s t o d j	k u s t o d j
d e s k o n e k t	d e s k o n e k t
i n f e k t	i n f e k t
l i d e r	l i d e r
d e s a o g	d e s a o g
k o l o r e	k o l o r e
p a t e n t	p a t e n t
x e s t	x e s t
m e r e n d	m e r y n d
k o n t r a r r e s t	k o n t r a r r e s t
e m p a r e n t	e m p a r e n t
a n e l	a n e l
s e j	s e j
a k o t	a k o t
r e s o p l	r e s o p l
r e b o l o t e	r e b o l o t e
p e s t a n j e	p e s t a n j e
p e r p e t r	p e r p e t r
e s t o r b	e s t o r b
a l b o r o t	a l b o r o t
r o N k	r o N k
d e n o t	d e n o t
e k s t r e m	e k s t r e m
l e s j o n	l e s j o n
a g o l p	a g o l p
m e r m	m e r m
k a n s e l	k a n s e l
e N k a r s e l	e N k a r s e l
r e t o m	r e t o m
i n s p e k s j o n	i n s p e k s j o n
e k s p o r t	e k s p o r t
t r a n s p a r e n t	t r a n s p a r e n t
r e b o s	r e b o s
l e C	l e C
a t r o p e j	a t r o p e j
a o r k	a o r k
m o l d e	m o l d e
s o b	s o b
b e r s	b e r s
l a d e	l a d e
i n s t r u m e n t	i n s t r u m e n t
e k s a s p e r	e k s a s p e r
a t i b o r r	a t i b o r r
n i b e l	n i b e l
a b o r t	a b o r t
a s e d j	a s e d j
p r o f e s	p r o f e s
s e k r e t	s e k r e t
o j	q j
b o m b a r d e	b o m b a r d e
s e b	s e b
k o s e C	k o s e C
d e s a l o x	d e s a l o x
f o j	f o j
k a t a l o g	k a t a l o g
s o p e s	s o p e s
a p e s t	a p e s t
p r i b i l e x j	p r i b i l e x j
k o l o r	k o l o r
s e r e n	s e r e n
s o j o s	s o j o s
e s p e s j	e s p e s j
d e l e g	d e l e g
b j o l e n t	b j o l e n t
r e x e n t	r e x e n t
n o b j	n o b i
s o l b e n t	s o l b e n t
e r r	y r r
a r r e	a r r e
k a r b o n	k a r b o n
a r r o j	a r r o j
o b j	o b j
r e t o k	r e t o k
p o s i s j o n	p o s i s j o n
r e f o r m	r e f o r m
k o n s y r n e	k o n s y r n e
a x e n t	a x e n t
r e p o r t	r e p o r t
o n d e	o n d e
e N k a d e n	e N k a d e n
r e p l e t	r e p l e t
e n r o s k	e n r o s k
k o N k o r d	k o N k q r d
e s t a s j o n	e s t a s j o n
a g o b j	a g o b j
b e d	b e d
k a n t u r r e	k a n t u r r e
e n m e n d	e n m y n d
a l a r d e	a l a r d e
e s k a s e	e s k a s e
d e r r o C	d e r r o C
e n s a N g r e n t	e n s a N g r y n t
a d o s	a d o s
f u s j o n	f u s j o n
b o t	b o t
p a t e	p a t e
a r r e s j	a r r e s j
i n t e n s	i n t e n s
r e d o n d e	r e d o n d e
d e g o j	d e g q j
f i l o s o f	f i l o s o f
a p r e s t	a p r e s t
t i t u b e	t i t u b e
o l g	q l g
s o n r o x	s o n r o x
e k s e p t w	e k s e p t u
l e n j	l e n j
f r a N k e	f r a N k e
b u s e	b u s e
m a n o s e	m a n o s e
d i s k r e p	d i s k r e p
e n a r b o l	e n a r b o l
k o m e r s j	k o m e r s j
r o s j	r o s i
x u g e t e	x u g e t e
d e s k o n t	d e s k q n t
a r r i N k o n	a r r i N k o n
u s m e	u s m e
t a p o n	t a p o n
o f e r t	o f e r t
d e s a b r o C	d e s a b r o C
t e s t i m o n j	t e s t i m o n j
b e r a n e	b e r a n e
a r r e s t	a r r e s t
k o n m e m o r	k o n m e m o r
e m b e l e s	e m b e l e s
e b a p o r	e b a p o r
a r k e	a r k e
r e p l e g	r e p l y g
i N k r e p	i N k r e p
b u l n e r	b u l n e r
t r o t	t r o t
e N k r e s p	e N k r e s p
a p r i s j o n	a p r i s j o n
e s p o l e	e s p o l e
o s p e d	o s p e d
e N k o r b	e N k o r b
d e s m a n t e l	d e s m a n t e l
d e s e n t e r r	d e s e n t y r r
r e s e t	r e s e t
a b e r j	a b e r i
f r a g m e n t	f r a g m e n t
s o s e g	s o s y g
r o t	r o t
r e m e d	r e m e d
p i l o t	p i l o t
d i b o r s j	d i b o r s j
e m p a r e x	e m p a r e x
e s p e x e	e s p e x e
r e s e n j	r e s e n j
g a l o p	g a l o p
p i s o t e	p i s o t e
a f o r	a f o r
a i r e	a i r e
t r o k	t r q k
p a l m e	p a l m e
d e n e g	d e n y g
e m b o b	e m b o b
r e k o n f o r t	r e k o n f o r t
m a l o g r	m a l o g r
a m e d r e n t	a m e d r e n t
C o r r e	C o r r e
t e m p l	t e m p l
a k s i d e n t	a k s i d e n t
k a b e s e	k a b e s e
g a t e	g a t e
r e b o l u s j o n	r e b o l u s j o n
s o b r e b o l	s o b r e b o l
k u C i C e	k u C i C e
e s t e b	e s t e b
d e x e n e r	d e x e n e r
C a p o t e	C a p o t e
r e s e l	r e s e l
d e s e n t o n	d e s e n t o n
k w a r t e	k w a r t e
a k o r t	a k o r t
t a r a r e	t a r a r e
s o n r o s	s o n r o s
m o r d i s k e	m o r d i s k e
m o n e d	m o n e d
r e g a t e	r e g a t e
a n e g	a n y g
p o s t e r g	p o s t e r g
e t i k e t	e t i k e t
a b r e b j	a b r e b j
e r o s j o n	e r o s j o n
a k o d	a k o d
r e e N k o n t r	r e e N k q n t r
i n t e r s e p t	i n t e r s e p t
b o l t e	b o l t e
d e s d o b l	d e s d o b l
r e n t	r e n t
t a n t e	t a n t e
p r e n d	p r e n d
a b r o C	a b r o C
a s e s t	a s y s t
a p a l e	a p a l e
a l i x e r	a l i x e r
e s p e s	e s p e s
i N x e n j	i N x e n j
a x e n s j	a x e n s j
r e t o s	r e t o s
e N k o n	e N k o n
o l f a t e	o l f a t e
d e s p e r e s	d e s p e r e s
l e g	l e g
e n t r e s e r r	e n t r e s y r r
p o s t r	p o s t r
m e N g w	m e N g w
m e n o s p r e s j	m e n o s p r e s j
b o s t e s	b o s t e s
x a d e	x a d e
p r e t e k s t	p r e t e k s t
r e k o n s i d e r	r e k o n s i d e r
a g u x e r e	a g u x e r e
b l a s f e m	b l a s f e m
k o r r e t e	k o r r e t e
r e f r e n d	r e f r e n d
a p o s e n t	a p o s e n t
a b o f e t e	a b o f e t e
k w o p e r	k w o p e r
k o x e	k o x e
e n r o l	e n r o l
a s o l	a s q l
b o m b e	b o m b e
d e s a l e n t	d e s a l y n t
e m p o t r	e m p o t r
t r e n s	t r e n s
e N g r o s	e N g r q s
e n t r e m e s k l	e n t r e m e s k l
r e i n t e g r	r e i n t e g r
d e r r o k	d e r r q k
a d o b	a d o b
a n e s t e s j	a n e s t e s j
r e g l	r e g l
i m p l o r	i m p l o r
p o n d e r	p o n d e r
p r e n s	p r e n s
d e s e r t	d e s e r t
k a w t e l	k a w t e l
t r o n	t r q n
a p r e m j	a p r e m j
t e l	t e l
a t a r e	a t a r e
r e x e n e r	r e x e n e r
p a l a d e	p a l a d e
a t e s o r	a t e s o r
r e p l a n t e	r e p l a n t e
r e g l a m e n t	r e g l a m e n t
a o n d	a o n d
d e s a s o n	d e s a s o n
k o n d e n s	k o n d e n s
a b a r r o t	a b a r r o t
p a r o d j	p a r o d j
f l a N k e	f l a N k e
t o s t	t q s t
i n t e r p e l	i n t e r p e l
a p e g	a p e g
s a n e	s a n e
r e s e k	r e s e k
s o t e r r	s o t y r r
a b s o r t	a b s o r t
a r o m	a r o m
k u r j o s e	k u r j o s e
m a t r i m o n j	m a t r i m o n j
s e r s j o r	s e r s j o r
m e d r	m e d r
r e k a l e n t	r e k a l y n t
b o s e	b o s e
d e s o r d e n	d e s o r d e n
a l e t e	a l e t e
d o k u m e n t	d o k u m e n t
t r a s t o k	t r a s t o k
d e n o s t	d e n q s t
p r e n j	p r e n j
e N k w a d e r n	e N k w a d e r n
x a b o n	x a b o n
t r o s e	t r o s e
k o N x e s t j o n	k o N x e s t j o n
k o m e d j	k o m e d j
a s e b e r	a s e b e r
k a l d e	k a l d e
i n f e s t	i n f e s t
s e x	s e x
p r u d e n s j	p r u d e n s j
s i m e n t	s i m y n t
b o s i f e r	b o s i f e r
d e s i l u s j o n	d e s i l u s j o n
a d e r e s	a d e r e s
r e l e b	r e l e b
m a n j o b r	m a n j o b r
t u t e	t u t e
s a k e	s a k e
s e k s j o n	s e k s j o n
a k a l o r	a k a l o r
d e l i n e	d e l i n e
d e s p o b l	d e s p q b l
a p o d	a p o d
x a l e	x a l e
k o r t e x	k o r t e x
e n e b r	e n e b r
f a n t a s e	f a n t a s e
d e l i b e r	d e l i b e r
k a p i t a n e	k a p i t a n e
k o n f o r t	k o n f o r t
i n t e r a k s j o n	i n t e r a k s j o n
a l b o r o s	a l b o r o s
p r o m e d j	p r o m e d j
e n d o s	e n d o s
d i s e k	d i s e k
m o s k e	m o s k e
b l a N k e	b l a N k e
a s k e	a s k e
k o n m o s j o n	k o n m o s j o n
C a s k e	C a s k e
e s l a b o n	e s l a b o n
d e s a s o s e g	d e s a s o s y g
e m p a k e t	e m p a k e t
a p a r e	a p a r e
o r d e n j	o r d e n j
d e s i n t e r e s	d e s i n t e r e s
e n e s t	e n y s t
e s k o b	e s k o b
a k o n d i s j o n	a k o n d i s j o n
t e t	t e t
a t r o n	a t r q n
e n a x e n	e n a x e n
f e r m e n t	f e r m e n t
e s p o N x	e s p o N x
d e s o x	d e s o x
d o m	d o m
r e k o l e k t	r e k o l e k t
C e k e	C e k e
r e s o l t	r e s o l t
a m i n o r	a m i n o r
a m o n e s t	a m o n e s t
e N k a n j o n	e N k a n j o n
s e r s e n	s e r s e n
d i s o s j	d i s o s j
k o n f e r e n s j	k o n f e r e n s j
m a n o t e	m a n o t e
e k s a s e r b	e k s a s e r b
d e s a p r o b e C	d e s a p r o b e C
p u t e	p u t e
e k s p r o p j	e k s p r o p j
d e s p e C	d e s p e C
e s k o t	e s k o t
k u m p l i m e n t	k u m p l i m e n t
m o f	m o f
r a s j o n	r a s j o n
a r e n	a r e n
p i k o t e	p i k o t e
e s p o l b o r e	e s p o l b o r e
r e i n t e r p r e t	r e i n t e r p r e t
a s e	a s e
d e r o g	d e r o g
r e m o d e l	r e m o d e l
f o r s e x e	f o r s e x e
o m o l o g	o m o l o g
p e d a l e	p e d a l e
e m p o l b	e m p o l b
a k o N g o x	a k o N g o x
o r k e s t	o r k e s t
g o t e	g o t e
d o k t o r	d o k t o r
e m b o r r o n	e m b o r r o n
m a l u m o r	m a l u m o r
i n t e r e s t e l	i n t e r e s t e l
x a l o n e	x a l o n e
e s k a r m e n t	e s k a r m y n t
r e s o N g	r e s o N g
d e s b o k	d e s b o k
p r o k r e	p r o k r e
d e n t	d y n t
r e d o b l	r e d o b l
d e s t r o n	d e s t r o n
s e r p e n t e	s e r p e n t e
e n t r e b e r	e n t r e b e r
k o k e t e	k o k e t e
a l e k s j o n	a l e k s j o n
e k s t e n w	e k s t e n u
f a l s e	f a l s e
a g a r r o t	a g a r r o t
r e k t	r e k t
d e s k o r a s o n	d e s k o r a s o n
u m e	u m e
r e m	r e m
t o r n e	t o r n e
t a r t a m u d e	t a r t a m u d e
m e j	m e j
d e s a k o n s e x	d e s a k o n s e x
b w i k o t e	b w i k o t e
d e s k o n s o l	d e s k o n s q l
r e p r o b	r e p r q b
b i s j o n	b i s j o n
e m b o s k	e m b o s k
a l f o m b r	a l f o m b r
r e m o s	r e m o s
t e k l e	t e k l e
o r e x	o r e x
k o n b u l s j o n	k o n b u l s j o n
r e m u n e r	r e m u n e r
i N k o m o d	i N k o m o d
b e n t	b y n t
j o r i k e	j o r i k e
r e b e r e n s j	r e b e r e n s j
p r o m e s	p r o m e s
t o r r	t o r r
e n r e x	e n r e x
s o n d e	s o n d e
a s e r	a s e r
b a r b o t	b a r b o t
d e s k o l o k	d e s k o l o k
a m b i s j o n	a m b i s j o n
d i m e n s j o n	d i m e n s j o n
s o p e	s o p e
e s k w a d r o n	e s k w a d r o n
k o n f r o n t	k o n f r o n t
p a r s e l	p a r s e l
a r r o s t r	a r r o s t r
e n t r e C o k	e n t r e C o k
p o r f j	p o r f i
r e t	r e t
r o n r o n e	r o n r o n e
e s e n s j	e s e n s j
o b s t	o b s t
d e p l o r	d e p l o r
s u k s j o n	s u k s j o n
r e k o m e n s	r e k o m e n s
a k o l C	a k o l C
k o d e	k o d e
e n e r b	e n e r b
t e x	t e x
k o n s t e r n	k o n s t e r n
n a w s e	n a w s e
e m b o l s	e m b o l s
b r e g	b r e g
a t e m p e r	a t e m p e r
r e m o l k	r e m o l k
s o m b r e	s o m b r e
b a n a g l o r j	b a n a g l o r j
a g o s t	a g o s t
s a b o t e	s a b o t e
t r a s n o C	t r a s n o C
b e r r e	b e r r e
a k o m p l e x	a k o m p l e x
a p a r e x	a p a r e x
k o n s e n s w	k o n s e n s w
f e d e r	f e d e r
d e s b l o k e	d e s b l o k e
e m b o s	e m b o s
e k s t e r n	e k s t e r n
x o r o b	x o r o b
b i l i p e n d j	b i l i p e n d j
m e r k	m e r k
d e s p r o p o r s j o n	d e s p r o p o r s j o n
d e s e n r e d	d e s e n r e d
t i n t i n e	t i n t i n e
k o s t e	k o s t e
s i n s e r	s i n s e r
r e d	r e d
s o b o r n	s o b o r n
b l a s o n	b l a s o n
r e i N k o r p o r	r e i N k o r p o r
a t o n t	a t o n t
C a p u r r e	C a p u r r e
f l e t	f l e t
a t r o f j	a t r o f j
b u l e b	b u l e b
b a l e	b a l e
a t e s t	a t y s t
d e s p e n j	d e s p e n j
a x e t r e	a x e t r e
g r a N x e	g r a N x e
r u m o r e	r u m o r e
a k a r t o n	a k a r t o n
r e k o n s e n t r	r e k o n s e n t r
e k s e p s j o n	e k s e p s j o n
p r o r r o g	p r o r r o g
d e s o j	d e s q j
a d e s e n t	a d e s e n t
l e b	l e b
s e n s	s e n s
s i m u l t a n e	s i m u l t a n e
C i s p e	C i s p e
k r o n o m e t r	k r o n o m e t r
e n t r o N k	e n t r o N k
a b a n d e r	a b a n d e r
k a C o n d e	k a C o n d e
a b u C e	a b u C e
k a m p e	k a m p e
a b o t o n	a b o t o n
k a p e	k a p e
d e s t e j	d e s t e j
b o k s e	b o k s e
d i s l o k	d i s l o k
l a b o r	l a b o r
p e r s e b e r	p e r s e b e r
e N x a b o n	e N x a b o n
i p o t e k	i p o t e k
f l e k s j o n	f l e k s j o n
C a n t a x e	C a n t a x e
d e s k a b e s	d e s k a b e s
a p l o m	a p l o m
a d u l t e r	a d u l t e r
m o s k	m o s k
a r r e d r	a r r e d r
p a t a l e	p a t a l e
a p o r r e	a p o r r e
t i r o n e	t i r o n e
s e r m o n	s e r m o n
p a r l o t e	p a r l o t e
e m p a p e l	e m p a p e l
e k s e n t	e k s e n t
g o l e	g o l e
t o r e	t o r e
b a m b o l e	b a m b o l e
s o s o b r	s o s o b r
t a k o n e	t a k o n e
r e p t	r e p t
f l a x e l	f l a x e l
i n m o l	i n m o l
r e m o x	r e m o x
r e i n s e r t	r e i n s e r t
d i s e r t	d i s e r t
p a l o m	p a l o m
m o b l	m q b l
r e p o b l	r e p q b l
k o r r e l a s j o n	k o r r e l a s j o n
d e s e m p o l b	d e s e m p o l b
r e k o l o k	r e k o l o k
d e s k o n C	d e s k o n C
b a b e	b a b e
m a s a x e	m a s a x e
d e s g l o s	d e s g l o s
e m b r o j	e m b r o j
a f e	a f e
g l o s	g l o s
i n t e r m e d j	i n t e r m e d j
x i m o t e	x i m o t e
a r r o b	a r r o b
f r a k s j o n	f r a k s j o n
e n s e s t	e n s e s t
a r r e n d	a r r y n d
r e f r e g	r e f r y g
r e n e g o s j	r e n e g o s j
i n s i n e r	i n s i n e r
p i n t a r r a x e	p i n t a r r a x e
d e s m e x o r	d e s m e x o r
a t r i n C e r	a t r i n C e r
a k o x o n	a k o x o n
a p r o b i s j o n	a p r o b i s j o n
k a r a k o l e	k a r a k o l e
d i l i x e n s j	d i l i x e n s j
k a r t e	k a r t e
a g l o m e r	a g l o m e r
k u l e b r e	k u l e b r e
g a r a b a t e	g a r a b a t e
d e s e m b o l s	d e s e m b o l s
s o b e r b j	s o b e r b j
r e f r e n	r e f r e n
r e b r o t	r e b r o t
r e b o s	r e b o s
m e n u d e	m e n u d e
k o n t r a p e s	k o n t r a p e s
i n n o b	i n n o b
e m b o k	e m b o k
k o l i s j o n	k o l i s j o n
k o m b	k o m b
o s t j	o s t j
k l a r e	k l a r e
d e s e k	d e s e k
b o s k e x	b o s k e x
b e k	b e k
f l a k e	f l a k e
o f r e n d	o f r e n d
n o k e	n o k e
g a l a r d o n	g a l a r d o n
t e r s	t e r s
a k o r d o n	a k o r d o n
e s k j	e s k i
m o t e x	m o t e x
t e C	t e C
f e r j	f e r j
r e o r d e n	r e o r d e n
e k s o r t	e k s o r t
k a b l e	k a b l e
k o n d i m e n t	k o n d i m e n t
d e s p o s	d e s p o s
r e b o k	r e b o k
o s j	o s j
b i s k e	b i s k e
t a m b o r i l e	t a m b o r i l e
p i n s e l	p i n s e l
d e s o n r	d e s o n r
r e m e n d	r e m y n d
k r o	k r o
r e p i k e t e	r e p i k e t e
e n l o d	e n l o d
e k s p o l j	e k s p o l j
t o r m e n t	t o r m e n t
e s t r e s	e s t r e s
k o s e	k o s e
C i s p o r r o t e	C i s p o r r o t e
k o r r e	k o r r e
d e s m e m b r	d e s m y m b r
d e s k o n t r o l	d e s k o n t r o l
d e s f o g	d e s f o g
r e N k e	r e N k e
t i r o t e	t i r o t e
r e p e l	r e p e l
p r e k a w s j o n	p r e k a w s j o n
a r b o l	a r b o l
k o l e	k o l e
s e k r e t e	s e k r e t e
s e g l	s e g l
s e l	s e l
d e s l o m	d e s l o m
b e x e t	b e x e t
p e n i t e n s j	p e n i t e n s j
p i r o p e	p i r o p e
o m e n a x e	o m e n a x e
m o n d	m o n d
r a m o n e	r a m o n e
k o m i s j o n	k o m i s j o n
e k s t o r s j o n	e k s t o r s j o n
o r n e	o r n e
s a l m o d j	s a l m o d j
k o t e x	k o t e x
r e f r i x e r	r e f r i x e r
o l e	o l e
k o n n o t	k o n n o t
d e s k a b e j	d e s k a b e j
e n t r e k o r t	e n t r e k o r t
b r a s e	b r a s e
k o m p e n d j	k o m p e n d j
k o n d e k o r	k o n d e k o r
i n t e r k o n e k t	i n t e r k o n e k t
t r o N k	t r o N k
e N g o l	e N g o l
l o	l o
m o l d	m o l d
k a N x e	k a N x e
d e l e t r e	d e l e t r e
r o j	r o j
m o t e	m o t e
r e s o j	r e s q j
f l e C	f l e C
p e n s j o n	p e n s j o n
e n b a l e n t o n	e n b a l e n t o n
s e d i m e n t	s e d i m e n t
d e s a r b o l	d e s a r b o l
a m a e s t r	a m a e s t r
m a s e r	m a s e r
a b o C o r n	a b o C o r n
a r t e s o n	a r t e s o n
k o n t o r s j o n	k o n t o r s j o n
a p a s e n t	a p a s y n t
k a s t a n j e t e	k a s t a n j e t e
e m b o t e j	e m b o t e j
a n e k s j o n	a n e k s j o n
f l a m e	f l a m e
r e p a t e	r e p a t e
p u n t e	p u n t e
o k s i x e n	o k s i x e n
d e s e r e d	d e s e r e d
o r n	o r n
t r a m p e	t r a m p e
p q n t e	p q n t e
d i s g r e g	d i s g r e g
i n d i x e s t	i n d i x e s t
e n d j o s	e n d j o s
d e s i n f o r m	d e s i n f o r m
g a r r a p a t e	g a r r a p a t e
e k s p j	e k s p i
m a l b e r s	m a l b e r s
b a g a b u n d e	b a g a b u n d e
b i t o r e	b i t o r e
k w a k s j o n	k w a k s j o n
d e s i n f e k t	d e s i n f e k t
o r m i g e	o r m i g e
r e s i d e n s j	r e s i d e n s j
b a l d e	b a l d e
d e s m a d e x	d e s m a d e x
e s p o n t a n e	e s p o n t a n e
k l o n	k l o n
a b e n t	a b y n t
C e k	C e k
f o t o k o p j	f o t o k o p j
d e s g r e n j	d e s g r e n j
i N x e r t	i N x e r t
a m o l d	a m o l d
k o n s e p t w	k o n s e p t u
t r a s t e	t r a s t e
e N k a x o n	e N k a x o n
o n o r	o n o r
b r o n s e	b r o n s e
r e k o n t	r e k q n t
s o n d	s o n d
r e p e s k	r e p e s k
b e s u k e	b e s u k e
i m p o s t	i m p o s t
p a b i m e n t	p a b i m e n t
e k s t r a p o l	e k s t r a p o l
r e m o l o n e	r e m o l o n e
a l e l	a l e l
k o N k a t e n	k o N k a t e n
d e s m e l e n	d e s m e l e n
i n s o l e n t	i n s o l e n t
b a d e	b a d e
t o n t e	t o n t e
d e s a f o r	d e s a f q r
i p e r t r o f j	i p e r t r o f i
a b e x e n t	a b e x e n t
k o m p e n e t r	k o m p e n e t r
s i n s e l	s i n s e l
k a y x e	k a y x e
d e s k o j	d e s k q j
k o n e k s j o n	k o n e k s j o n
u l s e r	u l s e r
f o n d e	f o n d e
s i g s a g e	s i g s a g e
s u x e s t j o n	s u x e s t j o n
m a l i n t e r p r e t	m a l i n t e r p r e t
a b u r g e s	a b u r g e s
e s k a l o f r j	e s k a l o f r i
l i n e	l i n e
a p e l o t o n	a p e l o t o n
a f r e n t	a f r e n t
d e s e m p l e	d e s e m p l e
a l f i l e r	a l f i l e r
i n f e r n	i n f y r n
k o n d o n	k o n d o n
k r o m	k r o m
e N k o k o r	e N k o k o r
d e s e n r o s k	d e s e n r o s k
r e i n b e n t	r e i n b e n t
k a r k a x e	k a r k a x e
s a s o n	s a s o n
f i s g o n e	f i s g o n e
e k s k r e t	e k s k r e t
C u l e	C u l e
b a p u l e	b a p u l e
k o m p a r t i m e n t	k o m p a r t i m e n t
l a g r i m e	l a g r i m e
d e s e r e b r	d e s e r e b r
s i l a b e	s i l a b e
d e s p e l o t	d e s p e l o t
k o n t o r n e	k o n t o r n e
i b e r n	i b e r n
t r a s e g	t r a s y g
e k s o n e r	e k s o n e r
d e s o b	d e s q b
d e s a b o t o n	d e s a b o t o n
a p i s o n	a p i s o n
e N k a p o t	e N k a p o t
a l m e n d r	a l m e n d r
d e b e N g	d e b e N g
a p e d r e	a p e d r e
e m p o n s o n j	e m p o n s o n j
d e s e n r o j	d e s e n r o j
t r a s f o r m	t r a s f o r m
a p o s t r o f	a p o s t r o f
d e s t e t	d e s t e t
d e s k o m p e n s	d e s k o m p e n s
k o N x e n j	k o N x e n j
a k r i s o l	a k r i s o l
e N k a b r o n	e N k a b r o n
d e s e n t r e n	d e s e n t r e n
p i b o t	p i b o t
o t o n j	o t o n j
d e s b r o s	d e s b r o s
r i b e t e	r i b e t e
a r e N g	a r e N g
g a l a n t e	g a l a n t e
b e x	b e x
t r a b e s	t r a b y s
d e s n i b e l	d e s n i b e l
d e s f o n d	d e s f o n d
k a r r o s	k a r r o s
b a r r e n	b a r r e n
k a k a r e	k a k a r e
e m p l o m	e m p l o m
m o k e	m o k e
m o n o l o g	m o n o l o g
i n f e k s j o n	i n f e k s j o n
d e s e n t r	d e s e n t r
s e g m e n t	s e g m e n t
d e s k o n s i d e r	d e s k o n s i d e r
e m b r o m	e m b r o m
e N x a l b e g	e N x a l b e g
b a i l o t e	b a i l o t e
s e r m o n e	s e r m o n e
f a s e t	f a s e t
d e s f l o r	d e s f l o r
d i p l o m	d i p l o m
d e s f l e k	d e s f l e k
a l g o d o n	a l g o d o n
a t o r	a t o r
s e n j o r e	s e n j o r e
j a m e	j a m e
a p r o n t	a p r o n t
d e s k o r C	d e s k o r C
d e s k o N x e l	d e s k o N x e l
d e s d e n t	d e s d y n t
a g i x o n e	a g i x o n e
a k o r C	a k o r C
k l a b e t e	k l a b e t e
s a N g o l o t e	s a N g o l o t e
s i s e	s i s e
d e k o l o r	d e k o l o r
b o k e	b o k e
d e t o n	d e t o n
i n d e k s	i n d e k s
f l i r t e	f l i r t e
a k o g o t	a k o g o t
e n t e l	e n t e l
r a t o n	r a t o n
d e s m o C	d e s m o C
a w r e o l	a w r e o l
a p o k	a p o k
o r e	o r e
r e t r e p	r e t r e p
p o s e s j o n	p o s e s j o n
m e t a m o r f o s e	m e t a m o r f o s e
p a r C e	p a r C e
p a s a p o r t	p a s a p o r t
a b r e b	a b r e b
t r a k e t e	t r a k e t e
t r i k o t	t r i k o t
a b o j	a b o j
i n s e n s	i n s y n s
a m o l	a m q l
d e s a r r e g l	d e s a r r e g l
i n t e r p e n e t r	i n t e r p e n e t r
s e m e n t	s e m e n t
p a r a f r a s e	p a r a f r a s e
s i N k o p	s i N k o p
p a r e	p a r e
d e p r e d	d e p r e d
d e s k o n t e n t	d e s k o n t y n t
p r o l o g	p r o l o g
k o r C	k o r C
d e f e k	d e f e k
a l m i d o n	a l m i d o n
d e s a p r o b	d e s a p r q b
e m b o t	e m b o t
p o l b e	p o l b e
d e s g a r r o n	d e s g a r r o n
g e r r e	g e r r e
a n e k s	a n e k s
s u p l e m e n t	s u p l e m e n t
d e s n o r t	d e s n o r t
a m p o j	a m p o j
a p j o l	a p j o l
s a p a t e	s a p a t e
p e t i s j o n	p e t i s j o n
r e g o l d	r e g q l d
a s e r r	a s y r r
k o l e k t	k o l e k t
C o C e	C o C e
b r u x u l e	b r u x u l e
p r e m o l	p r e m o l
C o r i s e	C o r i s e
d e s k o n b o k	d e s k o n b o k
i m p l e m e n t	i m p l e m e n t
i t e r	i t e r
a t e r s j o p e l	a t e r s j o p e l
r e o g	r e o g
a s e s	a s e s
p u l i m e n t	p u l i m e n t
b a p o r	b a p o r
p l o m	p l o m
o r n a m e n t	o r n a m e n t
e k s k a r s e l	e k s k a r s e l
r e b o l	r e b q l
o r l	o r l
e n s o p	e n s o p
e m p e r e s	e m p e r e s
r e x i m e n t	r e x i m y n t
r e l a m p a g e	r e l a m p a g e
t r a k e	t r a k e
d e s a s e l e r	d e s a s e l e r
a l t e r k	a l t e r k
k l o r	k l o r
d e p r e s j	d e p r e s j
m i n u s b a l o r	m i n u s b a l o r
d e s k o N x e s t j o n	d e s k o N x e s t j o n
a p e r s o n	a p e r s o n
a s p e r e s	a s p e r e s
e r n j	e r n j
g o r x e	g o r x e
b a s t a r d e	b a s t a r d e
d e s e n f o k	d e s e n f o k
a l a b e	a l a b e
d e s p e n	d e s p e n
r e t e m b l	r e t y m b l
d e s a s e r t	d e s a s y r t
a b o m b	a b o m b
a r r o j	a r r o j
e N x a e s	e N x a e s
m e n s t r w	m e n s t r u
r e m o l i n e	r e m o l i n e
m e C	m e C
g a s e	g a s e
s o b r e a l i m e n t	s o b r e a l i m e n t
m u l t i k o p j	m u l t i k o p j
e s k o p e t	e s k o p e t
t o k e t e	t o k e t e
a n t i n u k l e	a n t i n u k l e
d e r r e N g	d e r r y N g
f o r e s t	f o r e s t
r e f r o t	r e f r o t
i N k u r s j o n	i N k u r s j o n
a s u l e	a s u l e
a b n e g	a b n y g
a m o x o n	a m o x o n
r e e s t r e n	r e e s t r e n
t r a x e	t r a x e
f l a w t e	f l a w t e
a k a r a m e l	a k a r a m e l
a m a n e r	a m a n e r
r e f l o t	r e f l o t
a g r e m j	a g r e m j
a m o s k	a m o s k
e k s k r e m e n t	e k s k r e m e n t
s u b a l t e r n	s u b a l t e r n
i n t e r r e l a s j o n	i n t e r r e l a s j o n
C a n s e	C a n s e
d e s m a l e s	d e s m a l e s
d e s e s k o m b r	d e s e s k o m b r
p i r a t e	p i r a t e
a g u x e r	a g u x e r
a k w a r t e l	a k w a r t e l
e m p i k o t	e m p i k o t
e m p a r e d	e m p a r e d
e m b a n d e r	e m b a n d e r
b o g	b o g
e k s p a n s j o n	e k s p a n s j o n
m e l e	m e l e
a k o p j	a k o p j
r e d i m e n s j o n	r e d i m e n s j o n
e r u p s j o n	e r u p s j o n
k o N g l o m e r	k o N g l o m e r
a l o k	a l o k
d e s t e m p l	d e s t e m p l
d e s a p e g	d e s a p e g
s o b r e b a l o r	s o b r e b a l o r
a s e k j	a s e k j
e n C a l e k	e n C a l e k
e s t r j	e s t r i
e N k r e s t	e N k r e s t
m o r i x e r	m o r i x e r
b a n d e	b a n d e
s i l q t e	s i l q t e
m a r i p o s e	m a r i p o s e
e N k o l	e N k q l
t a p e	t a p e
d e s e l	d e s y l
e n s e b o j	e n s e b o j
a b e n	a b e n
p a r l a m e n t	p a r l a m e n t
s e s e	s e s e
i n b e r n	i n b y r n
r e p e n s	r e p y n s
a l e	a l e
f a n f a r r o n e	f a n f a r r o n e
s e s j o n	s e s j o n
a m e N g w	a m e N g w
a w t o x e n e r	a w t o x e n e r
t a b l e t e	t a b l e t e
e n s e l	e n s e l
d e p a w p e r	d e p a w p e r
d e s a k o r d	d e s a k q r d
a p e C	a p e C
k o n t r a b a n d e	k o n t r a b a n d e
e m b a l d o s	e m b a l d o s
a n a d e	a n a d e
b a k e t e	b a k e t e
C a C a r e	C a C a r e
k l o k e	k l o k e
f r i k s j o n	f r i k s j o n
e n l o s	e n l o s
b a r e	b a r e
l i m o s n e	l i m o s n e
d e s t r e n s	d e s t r e n s
d e s m e m o r j	d e s m e m o r j
a s a d o n	a s a d o n
a k a r e	a k a r e
a N g o s t	a N g o s t
m i s j o n	m i s j o n
k i l o m e t r	k i l o m e t r
d e s t e x	d e s t e x
C a p a l e	C a p a l e
x u r a m e n t	x u r a m e n t
a l a n s e	a l a n s e
C u p e t e	C u p e t e
p a s t o r e	p a s t o r e
o b l i t e r	o b l i t e r
b r o N k e	b r o N k e
r o n C	r o n C
d e s t o k	d e s t o k
d e s l e N g w	d e s l e N g w
k o n s e l e b r	k o n s e l e b r
e k s f o l j	e k s f o l j
g o l p e t e	g o l p e t e
a w t o f l a x e l	a w t o f l a x e l
s o b r e d o r	s o b r e d o r
a t o l o n d r	a t o l o n d r
t r e m o l	t r e m o l
a o r m	a o r m
d e s e n f r e n	d e s e n f r e n
C a p u s e	C a p u s e
k u l e	k u l e
d e s t e n s	d e s t e n s
t o r p e d e	t o r p e d e
k a n j o n e	k a n j o n e
a l b o r e	a l b o r e
p e N k	p e N k
l a s e r	l a s e r
e n d e m o n j	e n d e m o n j
m a N g o n e	m a N g o n e
p a t r o n e	p a t r o n e
d e s a r r o p	d e s a r r o p
k o n t r a s e n j	k o n t r a s e n j
g i t a r r e	g i t a r r e
r e i n t e p r e t	r e i n t e p r e t
r e s e j	r e s e j
r e a k o p l	r e a k o p l
d e s e m b o s	d e s e m b o s
p e s p u n t e	p e s p u n t e
k l o k	k l q k
f a l d e	f a l d e
s a k r a m e n t	s a k r a m e n t
r e i N g r e s	r e i N g r e s
i n f r a k s j o n	i n f r a k s j o n
e m b r e t	e m b r e t
p o r b o k	p o r b o k
e p i t o m	e p i t o m
d i s a s o s j	d i s a s o s j
t r a s p a p e l	t r a s p a p e l
a w t w i n m o l	a w t w i n m o l
a m o n t e s t	a m o n t e s t
e m u l s j o n	e m u l s j o n
b o l e	b o l e
a m o r r	a m o r r
d e s l a b o n	d e s l a b o n
r e e n b j	r e e n b j
b i s k o C	b i s k o C
m a l t e	m a l t e
k o l e t e	k o l e t e
p i l o t e	p i l o t e
s u b e m p l e	s u b e m p l e
a s p a b e n t	a s p a b e n t
e n s e r	e n s e r
d e s e m p e d r	d e s e m p y d r
a w t q k s p l o r	a w t q k s p l o r
b a l d o s	b a l d o s
s u b d e l e g	s u b d e l e g
f a k s e	f a k s e
e n t r e p e r n	e n t r e p y r n
d e s o r e x	d e s o r e x
r e f u n d a m e n t	r e f u n d a m e n t
a d i s j o n	a d i s j o n
a r p o n	a r p o n
t r o m p e	t r o m p e
e r m o s e	e r m o s e
r e e l a b o r	r e e l a b o r
d e s a d o r n	d e s a d o r n
s u b a l o r	s u b a l o r
g o l f e	g o l f e
d e s a r r e b o s	d e s a r r e b o s
b u r b u x e	b u r b u x e
m o C	m o C
r e t e n t	r e t y n t
p e n d e n s j	p e n d e n s j
b a b o s e	b a b o s e
d e s a r o j	d e s a r o j
p a l a N k e	p a l a N k e
d e s i n s e k t	d e s i n s e k t
r e f a k s j o n	r e f a k s j o n
k o n t r a r r e s t r	k o n t r a r r e s t r
a m o b l	a m q b l
r e k e b r	r e k y b r
l o N x e	l o N x e
s a l p i m e n t	s a l p i m y n t
g l o r j	g l o r i
d e s a t o r	d e s a t o r
e n s e r	e n s e r
C a r o l	C a r o l
e m p a b e s	e m p a b e s
k o n t r a b a l a n s e	k o n t r a b a l a n s e
m e r e N g	m e r e N g
a f r i x o l	a f r i x o l
k a t e	k a t e
e n s e n j o r	e n s e n j o r
e n t o r t	e n t o r t
d e s a k o p l	d e s a k o p l
e m p a n t a l o n	e m p a n t a l o n
r e a l o x	r e a l o x
k o m p a d r e	k o m p a d r e
k o n t o r n	k o n t o r n
a s o n	a s q n
r e f l e k t	r e f l e k t
e N g l o s	e N g l o s
a f o r r	a f o r r
e m p e d r	e m p y d r
l a t i g e	l a t i g e
a d i n e r	a d i n e r
e n f r e n	e n f r e n
e s t o f	e s t o f
f i l o s o f e	f i l o s o f e
d e s e N k o l	d e s e N k o l
e m p a d r o n	e m p a d r o n
s e s e	s e s e
t r a s p o r t	t r a s p o r t
r e a p r o b i s j o n	r e a p r o b i s j o n
k o l C	k o l C
d e s e N k a p o t	d e s e N k a p o t
e n f r e s k	e n f r e s k
a l o N g	a l o N g
C i k o l e	C i k o l e
d e s e N x a e s	d e s e N x a e s
a s o l e	a s o l e
k a s t a n j e	k a s t a n j e
d e s e m b o t	d e s e m b o t
p i g n o r	p i g n o r
e N x o j	e N x o j
e n r o k	e n r o k
x i n e t e	x i n e t e
a w t o n o m b r	a w t o n o m b r
p e s o t e	p e s o t e
d e s x a r r e t	d e s x a r r e t
d i s k u r s e	d i s k u r s e
d e s l j	d e s l i
r e k r j	r e k r i
d e s k o n d i s j o n	d e s k o n d i s j o n
r e e m b o l s	r e e m b o l s
b r o C	b r o C
e n s e b	e n s e b
i n d u l x e n s j	i n d u l x e n s j
e s p u m a r a x e	e s p u m a r a x e
s o b r e e m p l e	s o b r e e m p l e
a r a g a n e	a r a g a n e
g a N g r e n	g a N g r e n
d e s a s e	d e s a s e
g w a C a p e	g w a C a p e
r e s e p s j o n	r e s e p s j o n
a x i l i p o j	a x i l i p o j
d e s p j o x	d e s p j o x
a w t o p e r f e k s j o n	a w t o p e r f e k s j o n
l i s o N x e	l i s o N x e
i s t o r j	i s t o r j
a r r e b o s	a r r e b o s
p e l o t e	p e l o t e
d e s e m e x	d e s e m e x
p a l e	p a l e
l o n C	l o n C
d e s a p a s j o n	d e s a p a s j o n
s e l e s t i n e	s e l e s t i n e
a b r o g	a b r o g
d e s p a r e x	d e s p a r e x
e N k o s t r	e N k o s t r
t r a n s p r o t	t r a n s p r o t
a n j e x	a n j e x
a w t o g o b e r n	a w t o g o b y r n
d i s k o r d	d i s k q r d
e n l o s	e n l o s
e s p u m e	e s p u m e
d e s o x	d e s o x
a s i k a t e	a s i k a t e
m a l p e n s	m a l p e n s
a n t o r C	a n t o r C
r e k o n t e m p l	r e k o n t e m p l
r e k e m	r e k e m
e m p e l o t	e m p e l o t
a m b r e	a m b r e
k o n t u s j o n	k o n t u s j o n
d e s t e n t	d e s t e n t
r o m a n s e	r o m a n s e
p r e n e g o s j	p r e n e g o s j
d e s m e d r	d e s m e d r
r e k o C i n e	r e k o C i n e
e n r o n C	e n r o n C
k a t i t e	k a t i t e
d e s k a d e r	d e s k a d e r
C i n C o r r e	C i n C o r r e
k a C e t e	k a C e t e
m o n e	m o n e
d e s e N x a b o n	d e s e N x a b o n
d e s g o b e r n	d e s g o b y r n
a f r a n s e s	a f r a n s e s
s o b r e i m p r e s j o n	s o b r e i m p r e s j o n
a g o r	a g q r
s e n t e j	s e n t e j
a s u l e x	a s u l e x
p r e s e l e k s j o n	p r e s e l e k s j o n
d e f o r e s t	d e f o r e s t
e n s e n j o r e	e n s e n j o r e
p r e k a l e n t	p r e k a l e n t
a r x e n t	a r x e n t
e n f e n t r	e n f e n t r
k a r p i n t e	k a r p i n t e
p e n d e x e	p e n d e x e
C i s m e	C i s m e
e m p o j	e m p o j
s e n t o n	s e n t o n
C a N k l e t e	C a N k l e t e
b a r b e	b a r b e
a p l e b e j	a p l e b e j
e m b r e	e m b r e
e N g o m	e N g o m
k a r n e	k a r n e
m e t	m e t
e n d e n t	e n d y n t