d u	d I d
s e	s E d
g o	w E n t
g E t	g a t
n o	n u
s i	s ɔ
T I N k	T ɔ t
k ʌ m	k e m
t e k	t U k
l U k	l U k t
g I v	g e v
w ɔ n t	w ɔ n t ɨ d
f Y n d	f W n d
t E l	t o l d
s i m	s i m d
f i l	f E l t
b I k ʌ m	b I k e m
æ s k	æ s k t
p U t	p U t
j u z	j u z d
l i v	l E f t
t r Y	t r Y d
m i n	m E n t
k ɔ l	k ɔ l d
b I g I n	b I g æ n
k i p	k E p t
t R n	t R n d
n i d	n i d ɨ d
w R k	w R k t
l I v	l I v d
b r I N	b r ɔ t
t ɔ k	t ɔ k t
h i r	h R d
s I t	s æ t
S o	S o d
s t æ n d	s t U d
h o l d	h E l d
r Y t	r o t
C e n J	C e n J d
s t a r t	s t a r t ɨ d
r ʌ n	r æ n
h æ p ɨ n	h æ p ɨ n d
l E t	l E t
m u v	m u v d
b ɨ l i v	b ɨ l i v d
p l e	p l e d
h E l p	h E l p t
r i d	r E d
s p i k	s p o k
r I m E m b R	r I m E m b R d
p e	p e d
g r o	g r u
l u z	l ɔ s t
s t a p	s t a p t
l Y k	l Y k t
w e t	w e t ɨ d
s E t	s E t
k e r i	k e r i d
w ɔ k	w ɔ k t
l R n	l R n d
l R n	l R n t
l Y	l e
f a l o	f a l o d
l i d	l E d
f ɔ l	f E l
ɨ p i r	ɨ p i r d
ʌ n d R s t æ n d	ʌ n d R s t U d
i t	e t
I k s p E k t	I k s p E k t ɨ d
s p E n d	s p E n t
s E n d	s E n t
ɨ l W	ɨ l W d
k ɨ n t I n j u	k ɨ n t I n j u d
r I m e n	r I m e n d
p æ s	p æ s t
p r ɨ v Y d	p r ɨ v Y d ɨ d
b Y	b ɔ t
r i C	r i C t
d I v E l ɨ p	d I v E l ɨ p t
s t e	s t e d
w a C	w a C t
d I s Y d	d I s Y d ɨ d
p r ɨ d u s	p r ɨ d u s t
w e r	w o r
b I l d	b I l t
d Y	d Y d
l ʌ v	l ʌ v d
æ d	æ d ɨ d
m i t	m E t
I n k r i s	I n k r i s t
o p ɨ n	o p ɨ n d
s ɨ g J E s t	s ɨ g J E s t ɨ d
b r e k	b r o k
h o p	h o p t
s ɨ p o z	s ɨ p o z d
r I t R n	r I t R n d
d r Y v	d r o v
d r ɔ	d r u
I n v a l v	I n v a l v d
k I l	k I l d
k ɨ n s I d R	k ɨ n s I d R d
ɨ k s E p t	ɨ k s E p t ɨ d
ɔ f R	ɔ f R d
r i ɨ l Y z	r i ɨ l Y z d
I k s p l e n	I k s p l e n d
r Y z	r o z
k æ C	k ɔ t
ɨ g r i	ɨ g r i d
k ʌ t	k ʌ t
r I k w Y R	r I k w Y R d
p I k	p I k t
w I S	w I S t
p U l	p U l d
k ʌ v R	k ʌ v R d
C u z	C o z
l I s ɨ n	l I s ɨ n d
r e z	r e z d
w ʌ n d R	w ʌ n d R d
k ɔ z	k ɔ z d
ɨ r Y v	ɨ r Y v d
l æ f	l æ f t
f R g E t	f R g a t
æ n s R	æ n s R d
p l æ n	p l æ n d
d I s k r Y b	d I s k r Y b d
s m Y l	s m Y l d
k r i e t	k r i e t ɨ d
T r o	T r u
r I s i v	r I s i v d
w I n	w ʌ n
p r u v	p r u v d
s R v	s R v d
I n J O	I n J O d
f e l	f e l d
s E l	s o l d
J O n	J O n d
t i C	t ɔ t
d r a p	d r a p t
f Y t	f ɔ t
f o r s	f o r s t
E n d	E n d ɨ d
d I s k ʌ v R	d I s k ʌ v R d
r E k ɨ g n Y z	r E k ɨ g n Y z d
f I l	f I l d
f e s	f e s t
f i d	f E d
I g z I s t	I g z I s t ɨ d
p O n t	p O n t ɨ d
S e k	S U k
t E n d	t E n d ɨ d
n o t I s	n o t I s t
d r I N k	d r æ N k
E n t R	E n t R d
d I s k ʌ s	d I s k ʌ s t
s l i p	s l E p t
m æ n I J	m æ n I J d
h æ N	h ʌ N
I n k l u d	I n k l u d ɨ d
f o r m	f o r m d
f I n I S	f I n I S t
m e r i	m e r i d
s W n d	s W n d ɨ d
k ɨ n t e n	k ɨ n t e n d
p U S	p U S t
ɨ k R	ɨ k R d
I s t æ b l I S	I s t æ b l I S t
I m æ J ɨ n	I m æ J ɨ n d
æ k t	æ k t ɨ d
s e v	s e v d
k e r	k e r d
s t e r	s t e r d
l e	l e d
k r Y	k r Y d
k l o z	k l o z d
s ʌ f R	s ʌ f R d
s i k	s ɔ t
S e r	S e r d
a r g j u	a r g j u d
r I d u s	r I d u s t
ɨ C i v	ɨ C i v d
s ɨ p o r t	s ɨ p o r t ɨ d
ɨ p l Y	ɨ p l Y d
s t ʌ d i	s t ʌ d i d
T æ N k	T æ N k t
ɨ v O d	ɨ v O d ɨ d
r I f j u z	r I f j u z d
m E n C ɨ n	m E n C ɨ n d
ɨ k o r d	ɨ k o r d ɨ d
s t r Y k	s t r ʌ k
v I z ɨ t	v I z ɨ t ɨ d
ɨ s u m	ɨ s u m d
t ʌ C	t ʌ C t
I n k R I J	I n k R I J d
b e r	b o r
r I p o r t	r I p o r t ɨ d
I k s p r E s	I k s p r E s t
d i l	d E l t
r I m u v	r I m u v d
d I s t r O	d I s t r O d
r I g a r d	r I g a r d ɨ d
r E p r I z E n t	r E p r I z E n t ɨ d
h Y d	h I d
p l e s	p l e s t
k l e m	k l e m d
h I t	h I t
p r I z E n t	p r I z E n t ɨ d
t r i t	t r i t ɨ d
ɨ d m I t	ɨ d m I t ɨ d
w R i	w R i d
f l Y	f l u
m e n t e n	m e n t e n d
t r æ v ɨ l	t r æ v ɨ l d
I m p r u v	I m p r u v d
s t I k	s t ʌ k
p r I v E n t	p r I v E n t ɨ d
w ɔ S	w ɔ S t
k l Y m	k l Y m d
h e t	h e t ɨ d
I n t r ɨ d u s	I n t r ɨ d u s t
r I N	r æ N
m æ t R	m æ t R d
s R v Y v	s R v Y v d
o n	o n d
ɨ r e n J	ɨ r e n J d
l I f t	l I f t ɨ d
s p r E d	s p r E d
b R n	b R n d
b R n	b R n t
g e n	g e n d
p r E s	p r E s t
d I z Y n	d I z Y n d
k ɨ n t r o l	k ɨ n t r o l d
p ʌ b l I S	p ʌ b l I S t
b i t	b i t
o r d R	o r d R d
p r ɨ t E k t	p r ɨ t E k t ɨ d
m I s	m I s t
r I p l Y	r I p l Y d
k ɨ m p e r	k ɨ m p e r d
b l o	b l u
S W t	S W t ɨ d
C E k	C E k t
b ɨ l ɔ N	b ɨ l ɔ N d
a p ɨ r e t	a p ɨ r e t ɨ d
p r I f R	p r I f R d
d r E s	d r E s t
d I m æ n d	d I m æ n d ɨ d
I m R J	I m R J d
s E t ɨ l	s E t ɨ l d
ɨ p r o C	ɨ p r o C t
I n t E n d	I n t E n d ɨ d
p r I p e r	p r I p e r d
n a d	n a d ɨ d
p o r	p o r d
r I v i l	r I v i l d
f i r	f i r d
s I N	s æ N
ɨ t E m p t	ɨ t E m p t ɨ d
p R f o r m	p R f o r m d
r I f l E k t	r I f l E k t ɨ d
I n s I s t	I n s I s t ɨ d
I g z æ m I n	I g z æ m I n d
g E s	g E s t
g æ D R	g æ D R d
p r a m I s	p r a m I s t
k r ɔ s	k r ɔ s t
r I p l e s	r I p l e s t
I n d ɨ k e t	I n d ɨ k e t ɨ d
f I t	f I t
ɨ t E n d	ɨ t E n d ɨ d
S u t	S a t
ɨ n W n s	ɨ n W n s t
I k s t E n d	I k s t E n d ɨ d
ɨ f E k t	ɨ f E k t ɨ d
l i n	l i n d
r o l	r o l d
p e n t	p e n t ɨ d
k U k	k U k t
S ʌ t	S ʌ t
l æ s t	l æ s t ɨ d
I g n o r	I g n o r d
h æ n d	h æ n d ɨ d
ɨ t æ k	ɨ t æ k t
k ɨ l E k t	k ɨ l E k t ɨ d
ɨ b z R v	ɨ b z R v d
d I s ɨ p i r	d I s ɨ p i r d
Y d E n t ɨ f Y	Y d E n t ɨ f Y d
s t r E C	s t r E C t
ɨ b t e n	ɨ b t e n d
h R t	h R t
J ʌ m p	J ʌ m p t
h æ n d ɨ l	h æ n d ɨ l d
k ɨ m b Y n	k ɨ m b Y n d
s ɨ k s i d	s ɨ k s i d ɨ d
r I p i t	r I p i t ɨ d
w e k	w o k
b E n d	b E n t
d æ n s	d æ n s t
d I n Y	d I n Y d
I n v Y t	I n v Y t ɨ d
d I v Y d	d I v Y d ɨ d
p r ɨ p o z	p r ɨ p o z d
s ɨ s p E k t	s ɨ s p E k t ɨ d
T r E t ɨ n	T r E t ɨ n d
m Y n d	m Y n d ɨ d
k W n t	k W n t ɨ d
ɨ f o r d	ɨ f o r d ɨ d
o r g ɨ n Y z	o r g ɨ n Y z d
I m p l O	I m p l O d
l a k	l a k t
t e r	t o r
s l I p	s l I p t
t Y	t Y d
r I m Y n d	r I m Y n d ɨ d
ɨ r Y z	ɨ r o z
k a n s ɨ n t r e t	k a n s ɨ n t r e t ɨ d
k l i n	k l i n d
ɨ p o z	ɨ p o z d
I s k e p	I s k e p t
r I J E k t	r I J E k t ɨ d
n o t	n o t ɨ d
t r e n	t r e n d
k I s	k I s t
I n S u r	I n S u r d
ɨ d a p t	ɨ d a p t ɨ d
b a D R	b a D R d
n e m	n e m d
r I l i s	r I l i s t
ɨ k w Y R	ɨ k w Y R d
r I z ʌ l t	r I z ʌ l t ɨ d
v o t	v o t ɨ d
s t E p	s t E p t
r Y d	r o d
s æ t I s f Y	s æ t I s f Y d
v e r i	v e r i d
s w I N	s w ʌ N
d I f Y n	d I f Y n d
d I k l e r	d I k l e r d
k ɔ s t	k ɔ s t
p R s w e d	p R s w e d ɨ d
ɨ b æ n d ɨ n	ɨ b æ n d ɨ n d
t E s t	t E s t ɨ d
R n	R n d
ɨ t r æ k t	ɨ t r æ k t ɨ d
I n e b ɨ l	I n e b ɨ l d
l Y t	l I t
n a k	n a k t
k ɨ m I t	k ɨ m I t ɨ d
r I l æ k s	r I l æ k s t
d Y r E k t	d Y r E k t ɨ d
r I k ɔ l	r I k ɔ l d
s t i l	s t o l
r E s t	r E s t ɨ d
I k s p i r i ɨ n s	I k s p i r i ɨ n s t
s a l v	s a l v d
r I k o r d	r I k o r d ɨ d
ɨ s o s i e t	ɨ s o s i e t ɨ d
p r I t E n d	p r I t E n d ɨ d
k ɨ m p l e n	k ɨ m p l e n d
d I t R m I n	d I t R m I n d
r I s p a n d	r I s p a n d ɨ d
s ɨ p l Y	s ɨ p l Y d
s w i p	s w E p t
a k j ɨ p Y	a k j ɨ p Y d
r ʌ S	r ʌ S t
m I k s	m I k s t
s E p ɨ r e t	s E p ɨ r e t ɨ d
s t e t	s t e t ɨ d
b e r i	b e r i d
s I N k	s æ N k
w o r n	w o r n d
k l i r	k l i r d
m a r k	m a r k t
ɨ t æ C	ɨ t æ C t
s Y n	s Y n d
I k s p o z	I k s p o z d
s ɨ r W n d	s ɨ r W n d ɨ d
p r æ k t I s	p r æ k t I s t
s k r i m	s k r i m d
d r æ g	d r æ g d
k ɨ m p l i t	k ɨ m p l i t ɨ d
d e r	d e r d
f Y R	f Y R d
ɨ k ʌ m p ɨ n i	ɨ k ʌ m p ɨ n i d
t r ʌ s t	t r ʌ s t ɨ d
l o R	l o R d
d r Y	d r Y d
g l æ n s	g l æ n s t
p ɨ z E s	p ɨ z E s t
s m E l	s m E l d
s m E l	s m E l t
s u t	s u t ɨ d
d I f E n d	d I f E n d ɨ d
h E d	h E d ɨ d
s w I m	s w æ m
b l e m	b l e m d
d I l I v R	d I l I v R d
I k s p æ n d	I k s p æ n d ɨ d
I m p l Y	I m p l Y d
b I h e v	b I h e v d
d E m ɨ n s t r e t	d E m ɨ n s t r e t ɨ d
S I f t	S I f t ɨ d
w e v	w e v d
s R C	s R C t
C a r J	C a r J d
ɨ p r u v	ɨ p r u v d
f r i z	f r o z
s m o k	s m o k t
k ɨ n f R m	k ɨ n f R m d
I n g e J	I n g e J d
b r i D	b r i D d
I m p o z	I m p o z d
p R s u	p R s u d
g r æ n t	g r æ n t ɨ d
ɨ d m Y r	ɨ d m Y r d
k o p	k o p t
s t r ʌ g ɨ l	s t r ʌ g ɨ l d
s w I C	s w I C t
d I s t R b	d I s t R b d
s ɨ l E k t	s ɨ l E k t ɨ d
r E k ɨ m E n d	r E k ɨ m E n d ɨ d
w I T d r ɔ	w I T d r u
p R m I t	p R m I t ɨ d
ɨ d v Y z	ɨ d v Y z d
w I s p R	w I s p R d
b O l	b O l d
k ɨ n k l u d	k ɨ n k l u d ɨ d
d a m I n e t	d a m I n e t ɨ d
k ɨ n t r I b j u t	k ɨ n t r I b j u t ɨ d
k I k	k I k t
l I N k	l I N k t
r I k ʌ v R	r I k ʌ v R d
p ɔ z	p ɔ z d
r I z I s t	r I z I s t ɨ d
k æ s t	k æ s t
s t R	s t R d
m W n t	m W n t ɨ d
r ʌ b	r ʌ b d
v æ n I S	v æ n I S t
k w o t	k w o t ɨ d
p r ɨ s i d	p r ɨ s i d ɨ d
f I k s	f I k s t
k ɨ n E k t	k ɨ n E k t ɨ d
s o r t	s o r t ɨ d
J ʌ J	J ʌ J d
p r I z R v	p r I z R v d
d I g	d ʌ g
h R i	h R i d
r I t e n	r I t e n d
s E n s	s E n s t
ɔ l t R	ɔ l t R d
I n f l u ɨ n s	I n f l u ɨ n s t
l ɔ n C	l ɔ n C t
t w I s t	t w I s t ɨ d
R J	R J d
ɨ S u r	ɨ S u r d
I m p r E s	I m p r E s t
p æ k	p æ k t
f o l d	f o l d ɨ d
I S u	I S u d
b R s t	b R s t
k ɨ n d ʌ k t	k ɨ n d ʌ k t ɨ d
ɨ b z o r b	ɨ b z o r b d
d I s p l e	d I s p l e d
w e s t	w e s t ɨ d
d r i m	d r E m t
w Y p	w Y p t
r I l e t	r I l e t ɨ d
E m f ɨ s Y z	E m f ɨ s Y z d
d æ m I J	d æ m I J d
J E n ɨ r e t	J E n ɨ r e t ɨ d
w a n d R	w a n d R d
s i s	s i s t
r u l	r u l d
I n f o r m	I n f o r m d
l æ k	l æ k t
ɨ k j u z	ɨ k j u z d
f e d	f e d ɨ d
f o n	f o n d
s ʌ k	s ʌ k t
m E Z R	m E Z R d
k ɨ n v R t	k ɨ n v R t ɨ d
l I m I t	l I m I t ɨ d
p r I n t	p r I n t ɨ d
ɨ d r E s	ɨ d r E s t
e m	e m d
r æ p	r æ p t
d I s m I s	d I s m I s t
s l Y d	s l I d
ɨ p r i S i e t	ɨ p r i S i e t ɨ d
d I l Y t	d I l Y t ɨ d
I l E k t	I l E k t ɨ d
f l o	f l o d
k w E s C ɨ n	k w E s C ɨ n d
I g z ɔ s t	I g z ɔ s t ɨ d
S Y n	S o n
ɨ k W n t	ɨ k W n t ɨ d
s l o	s l o d
d W t	d W t ɨ d
ɨ k n a l I J	ɨ k n a l I J d
E s t ɨ m e t	E s t ɨ m e t ɨ d
s p r I N	s p r æ N
s p r I N	s p r ʌ N
ɨ r E s t	ɨ r E s t ɨ d
g r æ b	g r æ b d
s p l I t	s p l I t
I n v E n t	I n v E n t ɨ d
s w a l o	s w a l o d
r I s t o r	r I s t o r d
f R g I v	f R g e v
w E l k ɨ m	w E l k ɨ m d
p r ɨ m o t	p r ɨ m o t ɨ d
f l o t	f l o t ɨ d
d I k l Y n	d I k l Y n d
p a r t	p a r t ɨ d
s I k j u r	s I k j u r d
s i z	s i z d
o v R k ʌ m	o v R k e m
s w e r	s w o r
k ɨ n s i l	k ɨ n s i l d
d r I f t	d r I f t ɨ d
d I p E n d	d I p E n d ɨ d
b o r	b o r d
d I s t I N g w I S	d I s t I N g w I S t
d Y n	d Y n d
k ɨ n s ʌ l t	k ɨ n s ʌ l t ɨ d
S a k	S a k t
r I t Y R	r I t Y R d
t r ʌ b ɨ l	t r ʌ b ɨ l d
g r i t	g r i t ɨ d
f I S	f I S t
I l ɨ s t r e t	I l ɨ s t r e t ɨ d
l ɔ N	l ɔ N d
h Y R	h Y R d
m æ C	m æ C t
t r æ n s f R	t r æ n s f R d
b a r o	b a r o d
g e z	g e z d
r I m a r k	r I m a r k t
s t o r	s t o r d
I n t Y t ɨ l	I n t Y t ɨ l d
l i p	l E p t
k ɨ n v I n s	k ɨ n v I n s t
I k s p l O t	I k s p l O t ɨ d
b E g	b E g d
s Y	s Y d
C æ l ɨ n J	C æ l ɨ n J d
f W n d	f W n d ɨ d
k æ l k j U l e t	k æ l k j U l e t ɨ d
h E z ɨ t e t	h E z ɨ t e t ɨ d
I l I m ɨ n e t	I l I m ɨ n e t ɨ d
v j u	v j u d
p l æ n t	p l æ n t ɨ d
w e	w e d
f ɔ s t R	f ɔ s t R d
ʌ n d R t e k	ʌ n d R t U k
d r e n	d r e n d
m a r C	m a r C t
r I s p E k t	r I s p E k t ɨ d
s t a r t ɨ l	s t a r t ɨ l d
I n v E s t	I n v E s t ɨ d
l æ n d	l æ n d ɨ d
l I s t	l I s t ɨ d
k a n s t ɨ t u t	k a n s t ɨ t u t ɨ d
E k s R s Y z	E k s R s Y z d
s p O l	s p O l d
s p O l	s p O l t
ɨ d v æ n s	ɨ d v æ n s t
r E n t	r E n t ɨ d
s ɨ s t e n	s ɨ s t e n d
k ɨ l æ p s	k ɨ l æ p s t
k ɨ n d E m	k ɨ n d E m d
g e r ɨ n t i	g e r ɨ n t i d
t e r I f Y	t e r I f Y d
p r I d I k t	p r I d I k t ɨ d
h ʌ n t	h ʌ n t ɨ d
t r æ n s f o r m	t r æ n s f o r m d
t r E m b ɨ l	t r E m b ɨ l d
k ɨ n s t r ʌ k t	k ɨ n s t r ʌ k t ɨ d
l Y n	l Y n d
s t r E N T ɨ n	s t r E N T ɨ n d
r i æ k t	r i æ k t ɨ d
J ʌ s t ɨ f Y	J ʌ s t ɨ f Y d
k ɨ m æ n d	k ɨ m æ n d ɨ d
f I g j R	f I g j R d
s n æ p	s n æ p t
p r e	p r e d
b æ k	b æ k t
f ɨ l f I l	f ɨ l f I l d
b æ l ɨ n s	b æ l ɨ n s t
w i p	w E p t
k r I t I s Y z	k r I t I s Y z d
h i t	h i t ɨ d
r E J I s t R	r E J I s t R d
s k w i z	s k w i z d
m æ n j U f æ k C R	m æ n j U f æ k C R d
p o z	p o z d
l o d	l o d ɨ d
b Y t	b I t
p i r	p i r d
g r Y n d	g r W n d
I n t ɨ r ʌ p t	I n t ɨ r ʌ p t ɨ d
d ʌ b ɨ l	d ʌ b ɨ l d
ɨ b l Y J	ɨ b l Y J d
k l I N	k l ʌ N
l E n d	l E n t
I k s p l o r	I k s p l o r d
f l æ S	f l æ S t
o	o d
f l i	f l E d
g r I n	g r I n d
d I z R v	d I z R v d
f e v R	f e v R d
o b e	o b e d
s t r E s	s t r E s t
k ɨ m p o z	k ɨ m p o z d
r e n J	r e n J d
ɨ m j u z	ɨ m j u z d
k ɨ m p i t	k ɨ m p i t ɨ d
ɨ J ʌ s t	ɨ J ʌ s t ɨ d
k r i p	k r E p t
ɨ p O n t	ɨ p O n t ɨ d
d I f i t	d I f i t ɨ d
d I m I n I S	d I m I n I S t
ɨ d æ p t	ɨ d æ p t ɨ d
k ɨ n f r ʌ n t	k ɨ n f r ʌ n t ɨ d
I n k w Y R	I n k w Y R d
p r ɨ t E s t	p r ɨ t E s t ɨ d
k u l	k u l d
I m b e r ɨ s	I m b e r ɨ s t
k æ p C R	k æ p C R d
d I l e	d I l e d
g Y d	g Y d ɨ d
I n t R p r I t	I n t R p r I t ɨ d
s p I n	s p ʌ n
k ɨ n f E s	k ɨ n f E s t
t r æ p	t r æ p t
k r ɔ l	k r ɔ l d
r I z E m b ɨ l	r I z E m b ɨ l d
n I g l E k t	n I g l E k t ɨ d
g r æ s p	g r æ s p t
r I z a l v	r I z a l v d
r I v R s	r I v R s t
d I s E n d	d I s E n d ɨ d
d r W n	d r W n d
b E t	b E t
I m b r e s	I m b r e s t
h e r i	h e r i d
m R d R	m R d R d
k a m E n t	k a m E n t ɨ d
S r ʌ g	S r ʌ g d
w u n d	w u n d ɨ d
d e t	d e t ɨ d
p a r k	p a r k t
ɨ b J E k t	ɨ b J E k t ɨ d
I v a l v	I v a l v d
d I t E k t	d I t E k t ɨ d
m E l t	m E l t ɨ d
s m æ S	s m æ S t
I n h e r I t	I n h e r I t ɨ d
I k s C e n J	I k s C e n J d
b l i d	b l E d
k ɨ n f Y n	k ɨ n f Y n d
d I z Y R	d I z Y R d
r u I n	r u I n d
t æ k ɨ l	t æ k ɨ l d
s k r æ C	s k r æ C t
w o r m	w o r m d
I n s p Y R	I n s p Y R d
p R s I s t	p R s I s t ɨ d
ʌ n d R l Y	ʌ n d R l e
ɨ r W z	ɨ r W z d
k ɨ m j u n I k e t	k ɨ m j u n I k e t ɨ d
s ɨ b m I t	s ɨ b m I t ɨ d
f Y n æ n s	f Y n æ n s t
ɨ s E m b ɨ l	ɨ s E m b ɨ l d
b l a k	b l a k t
b r ʌ S	b r ʌ S t
f l I N	f l ʌ N
r I z Y n	r I z Y n d
b e k	b e k t
k ɨ n s u m	k ɨ n s u m d
k ɨ n s R n	k ɨ n s R n d
p ʌ n I S	p ʌ n I S t
ʌ p s E t	ʌ p s E t
ɨ s E s	ɨ s E s t
d I s t r I b j u t	d I s t r I b j u t ɨ d
s k o r	s k o r d
d I s l Y k	d I s l Y k t
I k s k l u d	I k s k l u d ɨ d
r I l i v	r I l i v d
m ʌ t R	m ʌ t R d
I n v E s t ɨ g e t	I n v E s t ɨ g e t ɨ d
k ɨ m p E l	k ɨ m p E l d
s ɨ p r E s	s ɨ p r E s t
s E l ɨ b r e t	s E l ɨ b r e t ɨ d
d I f R	d I f R d
ɨ s R t	ɨ s R t ɨ d
h R t ɨ l	h R t ɨ l d
k ɨ n v e	k ɨ n v e d
n i l	n E l t
n i l	n i l d
s p a t	s p a t ɨ d
i z	i z d
æ n ɨ l Y z	æ n ɨ l Y z d
f o k ɨ s	f o k ɨ s t
t e s t	t e s t ɨ d
o v R l U k	o v R l U k t
p r ɨ J E k t	p r ɨ J E k t ɨ d
I n k W n t R	I n k W n t R d
ɨ p i l	ɨ p i l d
ɨ w e t	ɨ w e t ɨ d
I k s p l o d	I k s p l o d ɨ d
r E k ɨ n	r E k ɨ n d
f r Y t ɨ n	f r Y t ɨ n d
p R s i v	p R s i v d
I n t R r f i r	I n t R r f i r d
j E l	j E l d
r e s	r e s t
t r e s	t r e s t
r I z E n t	r I z E n t ɨ d
p a r t I s I p e t	p a r t I s I p e t ɨ d
r o r	r o r d
k j u r	k j u r d
s t ʌ f	s t ʌ f t
æ n t I s ɨ p e t	æ n t I s ɨ p e t ɨ d
f r Y	f r Y d
f E C	f E C t
r i I n f o r s	r i I n f o r s t
s p e r	s p e r d
k ʌ m f R t	k ʌ m f R t ɨ d
f r ʌ s t r e t	f r ʌ s t r e t ɨ d
I m p o r t	I m p o r t ɨ d
I n t R v j u	I n t R v j u d
p a l I S	p a l I S t
k l ʌ C	k l ʌ C t
I n s p E k t	I n s p E k t ɨ d
r I v j u	r I v j u d
k r ʌ S	k r ʌ S t
f Y l	f Y l d
p Y l	p Y l d
k ɨ n f j u z	k ɨ n f j u z d
t ʌ k	t ʌ k t
i r I t e t	i r I t e t ɨ d
f r i	f r i d
t E l ɨ f o n	t E l ɨ f o n d
t r e d	t r e d ɨ d
p r ɨ v o k	p r ɨ v o k t
S r I N k	S r æ N k
S r I N k	S r ʌ N k
s t a r v	s t a r v d
s t ʌ m b ɨ l	s t ʌ m b ɨ l d
C e s	C e s t
ɨ s I s t	ɨ s I s t ɨ d
b æ n	b æ n d
C u	C u d
k ɨ n s i v	k ɨ n s i v d
n I g o S i e t	n I g o S i e t ɨ d
s t r I p	s t r I p t
d E k ɨ r e t	d E k ɨ r e t ɨ d
s e l	s e l d
s t r e n	s t r e n d
b I t r e	b I t r e d
p l ʌ n J	p l ʌ n J d
r I s k	r I s k t
t ɔ s	t ɔ s t
t r æ n s l e t	t r æ n s l e t ɨ d
w i k ɨ n	w i k ɨ n d
k r u z	k r u z d
p R C ɨ s	p R C ɨ s t
I n s t ɔ l	I n s t ɔ l d
s t I m j U l e t	s t I m j U l e t ɨ d
k a r v	k a r v d
d I p a r t	d I p a r t ɨ d
S æ t R	S æ t R d
C a p	C a p t
T r ʌ s t	T r ʌ s t
b E n ɨ f I t	b E n ɨ f I t ɨ d
k ɨ r E k t	k ɨ r E k t ɨ d
b E t R	b E t R d
b r i d	b r E d
I k s k j u z	I k s k j u z d
g ʌ v R n	g ʌ v R n d
p a p	p a p t
d æ m	d æ m d
f l R I S	f l R I S t
p l i d	p l i d ɨ d
d I z R t	d I z R t ɨ d
s i t	s i t ɨ d
s t r o k	s t r o k t
k r æ S	k r æ S t
r I z u m	r I z u m d
t E m p t	t E m p t ɨ d
d I v Y z	d I v Y z d
k r æ k	k r æ k t
I n d u r	I n d u r d
d I z a l v	d I z a l v d
s t r e t ɨ n	s t r e t ɨ n d
ɨ s Y n	ɨ s Y n d
g a r d	g a r d ɨ d
j i l d	j i l d ɨ d
E k o	E k o d
r E n d R	r E n d R d
d I s g Y z	d I s g Y z d
f R n I S	f R n I S t
p r a s E s	p r a s E s t
p l i z	p l i z d
m a d ɨ f Y	m a d ɨ f Y d
E J ɨ k e t	E J ɨ k e t ɨ d
s i l	s i l d
s w e	s w e d
ɨ p a l ɨ J Y z	ɨ p a l ɨ J Y z d
s p I l	s p I l d
s p I l	s p I l t
r E s k j u	r E s k j u d
s ʌ m ɨ n	s ʌ m ɨ n d
k a n t ɨ m p l e t	k a n t ɨ m p l e t ɨ d
s p E l	s p E l d
s p E l	s p E l t
s ɨ s p E n d	s ɨ s p E n d ɨ d
ʌ n d R g o	ʌ n d R w E n t
s I v I l Y z	s I v I l Y z d
m R m R	m R m R d
k w a l ɨ f Y	k w a l ɨ f Y d
s k r u	s k r u d
t Y t ɨ n	t Y t ɨ n d
ɨ n O	ɨ n O d
b l E s	b l E s t
r W n d	r W n d ɨ d
b æ t R	b æ t R d
p ʌ m p	p ʌ m p t
ɨ l E J	ɨ l E J d
w I t n I s	w I t n I s t
I n t ɨ g r e t	I n t ɨ g r e t ɨ d
ɨ f E n d	ɨ f E n d ɨ d
S I v R	S I v R d
p E n ɨ t r e t	p E n ɨ t r e t ɨ d
s k æ t R	s k æ t R d
d I s k R I J	d I s k R I J d
s n æ C	s n æ C t
s o k	s o k t
p r ɨ k l e m	p r ɨ k l e m d
d ʌ m p	d ʌ m p t
r I t r i t	r I t r i t ɨ d
S e p	S e p t
t r æ n z m I t	t r æ n z m I t ɨ d
b Y n d	b W n d
t Y p	t Y p t
p æ t	p æ t ɨ d
p O z ɨ n	p O z ɨ n d
p r e z	p r e z d
ɨ b a l I S	ɨ b a l I S t
f R b I d	f R b e d
f R b I d	f R b æ d
r I n u	r I n u d
ɨ m e z	ɨ m e z d
d I p	d I p t
I k s t r æ k t	I k s t r æ k t ɨ d
g r e z	g r e z d
h U k	h U k t
s w E t	s w E t ɨ d
g l o	g l o d
s p i d	s p E d
s t æ m p	s t æ m p t
f r W n	f r W n d
I n s t r ʌ k t	I n s t r ʌ k t ɨ d
m ʌ m b ɨ l	m ʌ m b ɨ l d
p r ɨ g r E s	p r ɨ g r E s t
d I v o r s	d I v o r s t
f æ n s i	f æ n s i d
I n k o r p R e t	I n k o r p R e t ɨ d
s l æ p	s l æ p t
I n f o r s	I n f o r s t
f æ s ɨ n e t	f æ s ɨ n e t ɨ d
r i r	r i r d
s I p	s I p t
k a p i	k a p i d
r I g r E t	r I g r E t ɨ d
w Y n d	w W n d
f l ʌ d	f l ʌ d ɨ d
I n d ʌ l J	I n d ʌ l J d
l e b ɨ l	l e b ɨ l d
t I p	t I p t
ɨ k j u m j ɨ l e t	ɨ k j u m j ɨ l e t ɨ d
k æ m p	k æ m p t
k ɨ n d I S ɨ n	k ɨ n d I S ɨ n d
r I w o r d	r I w o r d ɨ d
b æ N	b æ N d
b U k	b U k t
k æ n s ɨ l	k æ n s ɨ l d
g I g ɨ l	g I g ɨ l d
g l i m	g l i m d
b W n s	b W n s t
i k w ɨ l	i k w ɨ l d
I n k l o z	I n k l o z d
g æ s p	g æ s p t
p l W	p l W d
k e r I k t ɨ r Y z	k e r I k t ɨ r Y z d
ʌ n d R m Y n	ʌ n d R m Y n d
E m p t i	E m p t i d
I n d u s	I n d u s t
t æ p	t æ p t
ɨ l a r m	ɨ l a r m d
p r a p	p r a p t
b W	b W d
d I s k a r d	d I s k a r d ɨ d
æ d v R t Y z	æ d v R t Y z d
I n v e d	I n v e d ɨ d
J R k	J R k t
l o k e t	l o k e t ɨ d
W t l Y n	W t l Y n d
s R p r Y z	s R p r Y z d
b e t	b e t ɨ d
S E d	S E d
s ɨ r E n d R	s ɨ r E n d R d
k R l	k R l d
k R s	k R s t
s l æ m	s l æ m d
r e n	r e n d
r i ɨ S u r	r i ɨ S u r d
s ʌ b s t I t u t	s ʌ b s t I t u t ɨ d
b a r g I n	b a r g I n d
p I n	p I n d
s p I t	s p æ t
C i r	C i r d
r I v Y v	r I v Y v d
s w E l	s w E l d
ɨ k s E l ɨ r e t	ɨ k s E l ɨ r e t ɨ d
ɨ k a m p l I S	ɨ k a m p l I S t
k ɨ n t r æ k t	k ɨ n t r æ k t ɨ d
m I s l i d	m I s l E d
n e r o	n e r o d
I k s i d	I k s i d ɨ d
r æ t ɨ l	r æ t ɨ l d
ʌ n l a k	ʌ n l a k t
h i l	h i l d
r I p	r I p t
t a l ɨ r e t	t a l ɨ r e t ɨ d
ɨ k a m ɨ d e t	ɨ k a m ɨ d e t ɨ d
I n I S i e t	I n I S i e t ɨ d
p r ɨ n W n s	p r ɨ n W n s t
s k r æ m b ɨ l	s k r æ m b ɨ l d
s t i r	s t i r d
r i p r ɨ d u s	r i p r ɨ d u s t
r a b	r a b d
w R S I p	w R S I p t
k o w o r d I n e t	k o w o r d I n e t ɨ d
d I s t o r t	d I s t o r t ɨ d
g r I p	g r I p t
t r e l	t r e l d
t I l t	t I l t ɨ d
d I s p Y z	d I s p Y z d
t r a t	t r a t ɨ d
C o k	C o k t
E n t R t e n	E n t R t e n d
d I s ɨ g r i	d I s ɨ g r i d
d I s p o z	d I s p o z d
r I k r u t	r I k r u t ɨ d
d i k r i s	d i k r i s t
m ʌ l t I p l Y	m ʌ l t I p l Y d
r i b I l d	r i b I l t
k ɨ n s i d	k ɨ n s i d ɨ d
r I z R v	r I z R v d
æ d v ɨ k e t	æ d v ɨ k e t ɨ d
p o k	p o k t
s R v e	s R v e d
a n R	a n R d
s æ k r ɨ f Y s	s æ k r ɨ f Y s t
k ʌ l t I v e t	k ʌ l t I v e t ɨ d
ʌ t R	ʌ t R d
C i t	C i t ɨ d
k r W C	k r W C t
I n h æ n s	I n h æ n s t
I k s k l e m	I k s k l e m d
r a k	r a k t
k e t R	k e t R d
k a N k R	k a N k R d
S e v	S e v d
t i z	t i z d
I n t R v i n	I n t R v i n d
s æ n d w I C	s æ n d w I C t
b l I N k	b l I N k t
h ɔ n t	h ɔ n t ɨ d
h W z	h W z d
s k w e r	s k w e r d
b I w I l d R	b I w I l d R d
f l ʌ S	f l ʌ S t
m a n I t R	m a n I t R d
w i v	w o v
h o r I f Y	h o r I f Y d
r I s t r I k t	r I s t r I k t ɨ d
s I g n ɨ l	s I g n ɨ l d
s t e J	s t e J d
d I p a z I t	d I p a z I t ɨ d
h i v	h i v d
ɨ w o r d	ɨ w o r d ɨ d
I n l a r J	I n l a r J d
f l I k R	f l I k R d
w Y d ɨ n	w Y d ɨ n d
s t æ g R	s t æ g R d
s t E m	s t E m d
ɨ s t a n I S	ɨ s t a n I S t
r e J	r e J d
t a p	t a p t
d I s i v	d I s i v d
h ɔ l	h ɔ l d
m ɨ n I p j U l e t	m ɨ n I p j U l e t ɨ d
m o n	m o n d
r i g e n	r i g e n d
s t r Y v	s t r o v
k a n t æ k t	k a n t æ k t ɨ d
p ʌ z ɨ l	p ʌ z ɨ l d
ɨ t e n	ɨ t e n d
w I p	w I p t
d I k t e t	d I k t e t ɨ d
f o r m j U l e t	f o r m j U l e t ɨ d
f ʌ N k S ɨ n	f ʌ N k S ɨ n d
I m p l ɨ m E n t	I m p l ɨ m E n t ɨ d
v E n C R	v E n C R d
p r i C	p r i C t
r I s t r e n	r I s t r e n d
s t r o l	s t r o l d
d æ S	d æ S t
I g z æ J ɨ r e t	I g z æ J ɨ r e t ɨ d
E k s ɨ k j u t	E k s ɨ k j u t ɨ d
f ʌ n d	f ʌ n d ɨ d
S ʌ d R	S ʌ d R d
d æ z ɨ l	d æ z ɨ l d
r I k w E s t	r I k w E s t ɨ d
b o l	b o l d
I g z R t	I g z R t ɨ d
f l æ t R	f l æ t R d
s n I f	s n I f t
k a m	k a m d
k æ m p e n	k æ m p e n d
g r æ J u e t	g r æ J u e t ɨ d
k w I t	k w I t
w I s ɨ l	w I s ɨ l d
f r e m	f r e m d
w E l S	w E l S t
b a m	b a m d
d Y v	d o v
I n v I z I J	I n v I z I J d
f l ʌ t R	f l ʌ t R d
s o	s o d
s t r Y d	s t r o d
k l æ s p	k l æ s p t
h R l	h R l d
k ɔ f	k ɔ f t
h æ m R	h æ m R d
I m ɨ t e t	I m ɨ t e t ɨ d
p r I s i d	p r I s i d ɨ d
s E n t R	s E n t R d
k R v	k R v d
s k r e p	s k r e p t
v a m I t	v a m I t ɨ d
h ɔ l t	h ɔ l t ɨ d
E n v i	E n v i d
s u	s u d
m a r k I t	m a r k I t ɨ d
s k w a t	s k w a t ɨ d
e k	e k t
ɨ d o r	ɨ d o r d
s R k j U l e t	s R k j U l e t ɨ d
i r E k t	i r E k t ɨ d
I g z I b I t	I g z I b I t ɨ d
s t ʌ n	s t ʌ n d
b l R	b l R d
k a m b æ t	k a m b æ t ɨ d
k a m p E n s e t	k a m p E n s e t ɨ d
g l e r	g l e r d
p r o g r æ m	p r o g r æ m d
d Y v R t	d Y v R t ɨ d
s ɨ b J E k t	s ɨ b J E k t ɨ d
t r E d	t r a d
I n t r i g	I n t r i g d
l E v ɨ l	l E v ɨ l d
l I N g R	l I N g R d
S ʌ v	S ʌ v d
h ʌ v R	h ʌ v R d
n æ S ɨ n ɨ l Y z	n æ S ɨ n ɨ l Y z d
s t e n	s t e n d
T r Y v	T r Y v d
ɨ w e k ɨ n	ɨ w e k ɨ n d
Y s ɨ l e t	Y s ɨ l e t ɨ d
m R J	m R J d
f o t ɨ g r æ f	f o t ɨ g r æ f t
p r a m p t	p r a m p t ɨ d
s ʌ b s I d Y z	s ʌ b s I d Y z d
b o s t	b o s t ɨ d
d I b e t	d I b e t ɨ d
f o r s i	f o r s ɔ
S ʌ f ɨ l	S ʌ f ɨ l d
ɨ d m I n ɨ s t R	ɨ d m I n ɨ s t R d
k ɨ n f o r m	k ɨ n f o r m d
p o s t p o n	p o s t p o n d
C æ t	C æ t ɨ d
k W n t R	k W n t R d
d a r k ɨ n	d a r k ɨ n d
d I p I k t	d I p I k t ɨ d
d r I l	d r I l d
r a t	r a t ɨ d
s l Y s	s l Y s t
k l æ p	k l æ p t
r I p e r	r I p e r d
S r i k	S r i k t
I k s Y t	I k s Y t ɨ d
I m b a r k	I m b a r k t
I n h æ b I t	I n h æ b I t ɨ d
s t r æ N g ɨ l	s t r æ N g ɨ l d
s t r ʌ k C R	s t r ʌ k C R d
d I n W n s	d I n W n s t
I n s R t	I n s R t ɨ d
p r I z u m	p r I z u m d
p r I v e l	p r I v e l d
p r I s k r Y b	p r I s k r Y b d
s p r I N k ɨ l	s p r I N k ɨ l d
d I f Y	d I f Y d
d I p l O	d I p l O d
h ʌ g	h ʌ g d
k I d	k I d ɨ d
s t r i m	s t r i m d
k o a p ɨ r e t	k o a p ɨ r e t ɨ d
J o k	J o k t
b ʌ l J	b ʌ l J d
s R k ɨ l	s R k ɨ l d
s o	s o d
e l	e l d
k ɨ m p r Y z	k ɨ m p r Y z d
g r o n	g r o n d
h ʌ m	h ʌ m d
t ʌ m b ɨ l	t ʌ m b ɨ l d
h j u m I l i e t	h j u m I l i e t ɨ d
J æ m	J æ m d
k w I v R	k w I v R d
t r æ k	t r æ k t
r o t e t	r o t e t ɨ d
s m u D	s m u D d
s t æ k	s t æ k t
I n f E k t	I n f E k t ɨ d
k r ʌ m b ɨ l	k r ʌ m b ɨ l d
l I k	l I k t
s k E J u ɨ l	s k E J u ɨ l d
t o r C R	t o r C R d
l I b ɨ r e t	l I b ɨ r e t ɨ d
b l ʌ S	b l ʌ S t
s a b	s a b d
t u n	t u n d
I k s p E l	I k s p E l d
f l æ p	f l æ p t
l E k C R	l E k C R d
b ʌ m p	b ʌ m p t
s Y t	s Y t ɨ d
p e s	p e s t
s t i m	s t i m d
t ʌ g	t ʌ g d
b u m	b u m d
f l I k	f l I k t
I m p r I z ɨ n	I m p r I z ɨ n d
p r I z Y d	p r I z Y d ɨ d
k w o r ɨ l	k w o r ɨ l d
v æ l j u	v æ l j u d
k o I n s Y d	k o I n s Y d ɨ d
k r æ m	k r æ m d
k r I p ɨ l	k r I p ɨ l d
d u m	d u m d
f i C R	f i C R d
h I n t	h I n t ɨ d
s p E k j U l e t	s p E k j U l e t ɨ d
r I N k ɨ l	r I N k ɨ l d
k o r I s p a n d	k o r I s p a n d ɨ d
d I s t r E s	d I s t r E s t
f o r k æ s t	f o r k æ s t
g l I t R	g l I t R d
s k r ʌ b	s k r ʌ b d
m o t I v e t	m o t I v e t ɨ d
r e p	r e p t
f æ s ɨ n	f æ s ɨ n d
p R C	p R C t
p I C	p I C t
p ʌ n C	p ʌ n C t
I n s ʌ l t	I n s ʌ l t ɨ d
l i k	l i k t
s E n t ɨ n s	s E n t ɨ n s t
ʌ n d R l Y n	ʌ n d R l Y n d
d I t R	d I t R d
ɨ b s E s	ɨ b s E s t
C æ t R	C æ t R d
d r I p	d r I p t
w R l	w R l d
r E k	r E k t
I k s p o r t	I k s p o r t ɨ d
b a r k	b a r k t
b r u d	b r u d ɨ d
k ɨ n t r æ s t	k ɨ n t r æ s t ɨ d
d E d I k e t	d E d I k e t ɨ d
h a r m	h a r m d
I n J R	I n J R d
m I N g ɨ l	m I N g ɨ l d
s o r	s o r d
s p E S ɨ l Y z	s p E S ɨ l Y z d
s p l æ S	s p l æ S t
s p r e	s p r e d
k ɨ n v I k t	k ɨ n v I k t ɨ d
I k w I p	I k w I p t
h a r d ɨ n	h a r d ɨ n d
g r o p	g r o p t
r i s Y k ɨ l	r i s Y k ɨ l d
r I h R s	r I h R s t
t w I C	t w I C t
d I s p R s	d I s p R s t
h æ n d i k æ p	h æ n d i k æ p t
h W l	h W l d
I l u m I n e t	I l u m I n e t ɨ d
k l E n C	k l E n C t
I n d o r s	I n d o r s t
p æ n t	p æ n t ɨ d
s æ k	s æ k t
s w R l	s w R l d
ɨ p ɔ l	ɨ p ɔ l d
d æ N g ɨ l	d æ N g ɨ l d
ɨ r I J ɨ n e t	ɨ r I J ɨ n e t ɨ d
r I f o r m	r I f o r m d
I n t e l	I n t e l d
m I l k	m I l k t
p i l	p i l d
p a n d R	p a n d R d
k ɨ m p r E s	k ɨ m p r E s t
f o r J	f o r J d
h a r v I s t	h a r v I s t ɨ d
m a k	m a k t
s p E s I f Y	s p E s I f Y d
l u m	l u m d
p r a s ɨ k j u t	p r a s ɨ k j u t ɨ d
t I k	t I k t
ʌ n d u	ʌ n d I d
C I l	C I l d
I n d ʌ s t r i ɨ l Y z	I n d ʌ s t r i ɨ l Y z d
I n t E n s I f Y	I n t E n s I f Y d
o m I t	o m I t ɨ d
s ɔ f ɨ n	s ɔ f ɨ n d
k ɨ n f R	k ɨ n f R d
d I s I p l I n	d I s I p l I n d
d I s t r æ k t	d I s t r æ k t ɨ d
I n h I b I t	I n h I b I t ɨ d
m I n I m Y z	m I n I m Y z d
r i z ɨ n	r i z ɨ n d
s p a n s R	s p a n s R d
b o r d	b o r d ɨ d
f l æ t ɨ n	f l æ t ɨ n d
n I t	n I t
p I n C	p I n C t
s ʌ p l ɨ m E n t	s ʌ p l ɨ m E n t ɨ d
m I s t e k	m I s t U k
n ʌ m b R	n ʌ m b R d
r I t r i v	r I t r i v d
s k I p	s k I p t
w e l	w e l d
e d	e d ɨ d
E J	E J d
d I s p E n s	d I s p E n s t
t E s t ɨ f Y	t E s t ɨ f Y d
w i l	w i l d
k r ʌ m p ɨ l	k r ʌ m p ɨ l d
r E k ɨ n s Y l	r E k ɨ n s Y l d
r o s t	r o s t ɨ d
s k æ n	s k æ n d
s p r ɔ l	s p r ɔ l d
b æ t ɨ l	b æ t ɨ l d
d w E l	d w E l t
d w E l	d w E l d
g r ʌ n t	g r ʌ n t ɨ d
o v R w E l m	o v R w E l m d
s I g n I f Y	s I g n I f Y d
t r I g R	t r I g R d
ɨ p l ɔ d	ɨ p l ɔ d ɨ d
b e D	b e D d
k l I k	k l I k t
k ɨ n g r æ C U l e t	k ɨ n g r æ C U l e t ɨ d
d w I n d ɨ l	d w I n d ɨ l d
I v o k	I v o k t
l u s ɨ n	l u s ɨ n d
n æ g	n æ g d
T r I l	T r I l d
ɨ l R t	ɨ l R t ɨ d
d e z	d e z d
J E s C R	J E s C R d
r E g j U l e t	r E g j U l e t ɨ d
r W z	r W z d
b i m	b i m d
k l æ s I f Y	k l æ s I f Y d
d I s C a r J	d I s C a r J d
E d I t	E d I t ɨ d
I m b a d i	I m b a d i d
I k s p e r I m ɨ n t	I k s p e r I m ɨ n t ɨ d
p W n d	p W n d ɨ d
k o m	k o m d
ɨ b s k j u r	ɨ b s k j u r d
p ʌ f	p ʌ f t
k l o D	k l o D d
i r o d	i r o d ɨ d
f E l	f E l d
w ɔ t R	w ɔ t R d
ɨ s ɔ l t	ɨ s ɔ l t ɨ d
b U l i	b U l i d
C e r I S	C e r I S t
d I s ɨ p r u v	d I s ɨ p r u v d
f I l t R	f I l t R d
g l I s ɨ n	g l I s ɨ n d
h I s	h I s t
h ʌ d ɨ l	h ʌ d ɨ l d
p o r t r e	p o r t r e d
s I m R	s I m R d
j u n I f Y	j u n I f Y d
b l Y n d	b l Y n d ɨ d
f ʌ m b ɨ l	f ʌ m b ɨ l d
h e s ɨ n	h e s ɨ n d
o v R t e k	o v R t U k
S a r p ɨ n	S a r p ɨ n d
s t Y f ɨ l	s t Y f ɨ l d
t Y d i	t Y d i d
d I k e	d I k e d
f u l	f u l d
m o b ɨ l Y z	m o b ɨ l Y z d
p æ d	p æ d ɨ d
s t e r ɨ l Y z	s t e r ɨ l Y z d
t æ N g ɨ l	t æ N g ɨ l d
k ɨ n t E n d	k ɨ n t E n d ɨ d
d r E d	d r E d ɨ d
f I l m	f I l m d
h a p	h a p t
l R k	l R k t
r I v Y z	r I v Y z d
s i z ɨ n	s i z ɨ n d
s t a k	s t a k t
I s k o r t	I s k o r t ɨ d
f l e r	f l e r d
m æ s t R	m æ s t R d
p ɨ l u t	p ɨ l u t ɨ d
p r o b	p r o b d
S E l t R	S E l t R d
w I D R	w I D R d
b r u z	b r u z d
d ʌ s t	d ʌ s t ɨ d
h ʌ n C	h ʌ n C t
l æ S	l æ S t
n R s	n R s t
p e r ɨ l Y z	p e r ɨ l Y z d
r I s i d	r I s i d ɨ d
s u p R v Y z	s u p R v Y z d
t r æ n s E n d	t r æ n s E n d ɨ d
t r I m	t r I m d
ʌ n d R E s t ɨ m e t	ʌ n d R E s t ɨ m e t ɨ d
e J	e J d
e l i ɨ n e t	e l i ɨ n e t ɨ d
d a r t	d a r t ɨ d
d I J E s t	d I J E s t ɨ d
I v æ l j u e t	I v æ l j u e t ɨ d
g r ʌ m b ɨ l	g r ʌ m b ɨ l d
m E n d	m E n d ɨ d
p l ʌ k	p l ʌ k t
s æ g	s æ g d
s I d u s	s I d u s t
s t I N	s t ʌ N
a r C	a r C t
k ɨ m I S ɨ n	k ɨ m I S ɨ n d
r I s Y t	r I s Y t ɨ d
s t ɔ k	s t ɔ k t
j u n Y t	j u n Y t ɨ d
b u s t	b u s t ɨ d
s E n t r ɨ l Y z	s E n t r ɨ l Y z d
m ɨ t S u r	m ɨ t S u r d
s k r i n	s k r i n d
ʌ n d r E s	ʌ n d r E s t
w e d	w e d ɨ d
d I v W R	d I v W R d
d r u p	d r u p t
s I m b ɨ l Y z	s I m b ɨ l Y z d
b l E n d	b l E n d ɨ d
p l a t	p l a t ɨ d
r i ɨ p i r	r i ɨ p i r d
r I n s	r I n s t
k ʌ p ɨ l	k ʌ p ɨ l d
ɨ p r E s	ɨ p r E s t
p ɨ z I S ɨ n	p ɨ z I S ɨ n d
S a p	S a p t
s ʌ m ɨ r Y z	s ʌ m ɨ r Y z d
æ l ɨ k e t	æ l ɨ k e t ɨ d
b l æ k	b l æ k t
k r i k	k r i k t
I n d e n J R	I n d e n J R d
I v æ p ɨ r e t	I v æ p ɨ r e t ɨ d
h R æ s	h R æ s t
t o r m E n t	t o r m E n t ɨ d
ɨ w e k	ɨ w o k
b E k ɨ n	b E k ɨ n d
d Y ɨ l	d Y ɨ l d
I n v o k	I n v o k t
p o s t	p o s t ɨ d
s t o r m	s t o r m d
d I s r ʌ p t	d I s r ʌ p t ɨ d
s l o p	s l o p t
k l e r I f Y	k l e r I f Y d
p i r s	p i r s t
S o r t ɨ n	S o r t ɨ n d
s ɨ b s Y d	s ɨ b s Y d ɨ d
w I N k	w I N k t
d I s I n t ɨ g r e t	d I s I n t ɨ g r e t ɨ d
d Y	d Y d
l E s ɨ n	l E s ɨ n d
r i p e	r i p e d
s Y l ɨ n s	s Y l ɨ n s t
s w o r m	s w o r m d
t r æ m p ɨ l	t r æ m p ɨ l d
k l æ m b R	k l æ m b R d
d I s k l o z	d I s k l o z d
p Y ɨ n i r	p Y ɨ n i r d
r I z o r t	r I z o r t ɨ d
s t æ b	s t æ b d
b a b	b a b d
d I g r e d	d I g r e d ɨ d
m æ k s I m Y z	m æ k s I m Y z d
o v R k r W d	o v R k r W d ɨ d
v a l ɨ n t i r	v a l ɨ n t i r d
r E s ɨ l	r E s ɨ l d
ɔ T ɨ r Y z	ɔ T ɨ r Y z d
s O l	s O l d
t Y R	t Y R d
æ N g R	æ N g R d
ɨ v R t	ɨ v R t ɨ d
k ɨ m p W n d	k ɨ m p W n d ɨ d
k a m p r I h E n d	k a m p r I h E n d ɨ d
d i p ɨ n	d i p ɨ n d
m I s ʌ n d R s t æ n d	m I s ʌ n d R s t U d
m o l d	m o l d ɨ d
m ʌ f ɨ l	m ʌ f ɨ l d
W t r e J	W t r e J d
s k I m	s k I m d
t r I k ɨ l	t r I k ɨ l d
ʌ n f o l d	ʌ n f o l d ɨ d
C æ n t	C æ n t ɨ d
k r a p	k r a p t
I n t r ɨ s t	I n t r ɨ s t ɨ d
ɔ f s E t	ɔ f s E t
p r ɨ t r u d	p r ɨ t r u d ɨ d
b ʌ z	b ʌ z d
k r W d	k r W d ɨ d
I n s u	I n s u d
I v e d	I v e d ɨ d
g r e d	g r e d ɨ d
m E s	m E s t
p ɨ l i s	p ɨ l i s t
r I g ɨ l	r I g ɨ l d
j ɔ n	j ɔ n d
k a m p l ɨ k e t	k a m p l ɨ k e t ɨ d
l I t R	l I t R d
p r o h I b ɨ t	p r o h I b ɨ t ɨ d
s k e r	s k e r d
s t u p	s t u p t
d I m a l I S	d I m a l I S t
d I s p l e s	d I s p l e s t
d r e p	d r e p t
t r æ n s p o r t	t r æ n s p o r t ɨ d
I n r I C	I n r I C t
l a J	l a J d
b æ f ɨ l	b æ f ɨ l d
k a n t r ɨ d I k t	k a n t r ɨ d I k t ɨ d
d I t i r i ɨ r e t	d I t i r i ɨ r e t ɨ d
n R I S	n R I S t
r o m	r o m d
T r æ S	T r æ S t
j u t ɨ l Y z	j u t ɨ l Y z d
v Y ɨ l e t	v Y ɨ l e t ɨ d
b l e z	b l e z d
d W n	d W n d
f l W R	f l W R d
p æ k I J	p æ k I J d
p ʌ b l ɨ s Y z	p ʌ b l ɨ s Y z d
r I b E l	r I b E l d
s u D	s u D d
r Y D	r Y D d
d E z I g n e t	d E z I g n e t ɨ d
h e l	h e l d
m e t	m e t ɨ d
r e d	r e d ɨ d
s E v R	s E v R d
k ɨ n s a l I d e t	k ɨ n s a l I d e t ɨ d
d I p l o r	d I p l o r d
i m I t	i m I t ɨ d
s I m p l I f Y	s I m p l I f Y d
ɨ s p Y R	ɨ s p Y R d
m æ g n I f Y	m æ g n I f Y d
s l ʌ m p	s l ʌ m p t
b l æ s t	b l æ s t ɨ d
b ʌ t ɨ n	b ʌ t ɨ n d
k ɨ n f Y d	k ɨ n f Y d ɨ d
d o z	d o z d
f ɨ s I l ɨ t e t	f ɨ s I l ɨ t e t ɨ d
k I d n æ p	k I d n æ p t
l R C	l R C t
r æ N k	r æ N k t
s l ɔ t R	s l ɔ t R d
s p r W t	s p r W t ɨ d
f æ S ɨ n	f æ S ɨ n d
o v R l æ p	o v R l æ p t
s t e S ɨ n	s t e S ɨ n d
T I n	T I n d
t r I p	t r I p t
ɔ l t R n e t	ɔ l t R n e t ɨ d
d I p r E s	d I p r E s t
J E n ɨ r ɨ l Y z	J E n ɨ r ɨ l Y z d
r e n	r e n d
s k u p	s k u p t
s k w I n t	s k w I n t ɨ d
d ʌ k	d ʌ k t
m æ n I f E s t	m æ n I f E s t ɨ d
r I v a l v	r I v a l v d
ɨ b j u z	ɨ b j u z d
k a k	k a k t
f l I p	f l I p t
g i r	g i r d
ʌ n k ʌ v R	ʌ n k ʌ v R d
ʌ n l o d	ʌ n l o d ɨ d
ʌ S R	ʌ S R d
w I s k	w I s k t
w i l d	w i l d ɨ d
ɨ s E n d	ɨ s E n d ɨ d
b ʌ b ɨ l	b ʌ b ɨ l d
k æ S	k æ S t
g e p	g e p t
r E l I S	r E l I S t
s k r I b ɨ l	s k r I b ɨ l d
T ʌ m p	T ʌ m p t
w I T h o l d	w I T h E l d
I f E k t	I f E k t ɨ d
f I d ɨ l	f I d ɨ l d
h ʌ S	h ʌ S t
m æ n	m æ n d
n o t I f Y	n o t I f Y d
p l ʌ g	p l ʌ g d
s m ʌ D R	s m ʌ D R d
r I N	r ʌ N
r I k R	r I k R d
k ɨ m p j u t	k ɨ m p j u t ɨ d
I n l I s t	I n l I s t ɨ d
m ɨ n u v R	m ɨ n u v R d
p e r I S	p e r I S t
r I f r e n	r I f r e n d
s n a r l	s n a r l d
v I Z u ɨ l Y z	v I Z u ɨ l Y z d
k l æ t R	k l æ t R d
d I s p æ C	d I s p æ C t
I m b r O d R	I m b r O d R d
f e n t	f e n t ɨ d
l I m p	l I m p t
w I T s t æ n d	w I T s t U d
æ v R I J	æ v R I J d
k ɨ n s R v	k ɨ n s R v d
g l Y d	g l Y d ɨ d
h Y l Y t	h Y l Y t ɨ d
r æ l i	r æ l i d
S I m R	S I m R d
T I k ɨ n	T I k ɨ n d
w Y n	w Y n d
k ɨ r E s	k ɨ r E s t
k l ʌ s t R	k l ʌ s t R d
d I s k r I m I n e t	d I s k r I m I n e t ɨ d
I n C æ n t	I n C æ n t ɨ d
s t E d i	s t E d i d
b æ n I S	b æ n I S t
C ʌ k ɨ l	C ʌ k ɨ l d
k o t	k o t ɨ d
k r W n	k r W n d
f a r m	f a r m d
l e b R	l e b R d
ɨ s I m ɨ l e t	ɨ s I m ɨ l e t ɨ d
b æ t	b æ t ɨ d
k a m p r ɨ m Y z	k a m p r ɨ m Y z d
d a t	d a t ɨ d
I n g ʌ l f	I n g ʌ l f t
I n r e J	I n r e J d
s k i	s k i d
s l æ S	s l æ S t
w i n	w i n d
b ʌ g	b ʌ g d
k ɨ m p l Y	k ɨ m p l Y d
k r E d I t	k r E d I t ɨ d
I n d W	I n d W d
h a r n I s	h a r n I s t
I n k R	I n k R d
n e l	n e l d
S i l d	S i l d ɨ d
s m i r	s m i r d
k ɨ n t r Y v	k ɨ n t r Y v d
d I s p j u t	d I s p j u t ɨ d
l E N T ɨ n	l E N T ɨ n d
s t r e	s t r e d
ʌ p h o l d	ʌ p h E l d
r E n C	r E n C t
b o l t	b o l t ɨ d
k ɨ r ʌ p t	k ɨ r ʌ p t ɨ d
s Y k ɨ l	s Y k ɨ l d
d ɔ n	d ɔ n d
g æ l ɨ p	g æ l ɨ p t
I n J E k t	I n J E k t ɨ d
m o r n	m o r n d
p r a d	p r a d ɨ d
v Y b r e t	v Y b r e t ɨ d
w e v R	w e v R d
b æ T	b æ T t
b r ɔ d ɨ n	b r ɔ d ɨ n d
d I t E s t	d I t E s t ɨ d
d I s r I g a r d	d I s r I g a r d ɨ d
Y	Y d
f ʌ s	f ʌ s t
g r W l	g r W l d
o v R h i r	o v R h R d
s k E C	s k E C t
s n i k	s n ʌ k
f æ n	f æ n d
g l I m p s	g l I m p s t
h Y t ɨ n	h Y t ɨ n d
n R C R	n R C R d
p æ n I k	p æ n I k t
s e f g a r d	s e f g a r d ɨ d
S e d	S e d ɨ d
ɨ f I l i e t	ɨ f I l i e t ɨ d
b W n d	b W n d ɨ d
b r u	b r u d
d Y ɨ g n o s	d Y ɨ g n o s t
d I R E n C i e t	d I R E n C i e t ɨ d
g r i s	g r i s t
h æ k	h æ k t
h I p n ɨ t Y z	h I p n ɨ t Y z d
m ɨ t i r i ɨ l Y z	m ɨ t i r i ɨ l Y z d
s m æ k	s m æ k t
s t o n	s t o n d
s ɨ k ʌ m	s ɨ k ʌ m d
T ʌ n d R	T ʌ n d R d
b a r	b a r d
b r e s	b r e s t
C e n	C e n d
C æ n ɨ l	C æ n ɨ l d
i r ʌ p t	i r ʌ p t ɨ d
p r a s p R	p r a s p R d
r Y v ɨ l	r Y v ɨ l d
s t I f ɨ n	s t I f ɨ n d
k o r t	k o r t ɨ d
d i m	d i m d
d r æ f t	d r æ f t ɨ d
I m b E d	I m b E d ɨ d
r e d i e t	r e d i e t ɨ d
r I J O s	r I J O s t
w E l d	w E l d ɨ d
k l ɔ	k l ɔ d
k ɨ n v R J	k ɨ n v R J d
f i l d	f i l d ɨ d
g r I l	g r I l d
I n s ɨ l e t	I n s ɨ l e t ɨ d
f e z	f e z d
s t r æ p	s t r æ p t
ɨ f R m	ɨ f R m d
ɨ s t W n d	ɨ s t W n d ɨ d
k o C	k o C t
k ɨ n s o l	k ɨ n s o l d
d I s m æ n t ɨ l	d I s m æ n t ɨ l d
m I l	m I l d
s l I N	s l ʌ N
s t r u	s t r u d
s R J	s R J d
æ n I m e t	æ n I m e t ɨ d
b a t ɨ l	b a t ɨ l d
b ʌ s ɨ l	b ʌ s ɨ l d
k ʌ l R	k ʌ l R d
m a p	m a p t
p r Y s	p r Y s t
r e k	r e k t
s m ʌ g ɨ l	s m ʌ g ɨ l d
s w a p	s w a p t
j R n	j R n d
ɨ f l I k t	ɨ f l I k t ɨ d
d i t e l	d i t e l d
p R p E C u e t	p R p E C u e t ɨ d
a r m	a r m d
b o r d R	b o r d R d
b r ɔ d k æ s t	b r ɔ d k æ s t ɨ d
C I p	C I p t
d I s a r m	d I s a r m d
E s k ɨ l e t	E s k ɨ l e t ɨ d
f l a p	f l a p t
h i p	h i p t
m ʌ s t R	m ʌ s t R d
p a p j U l e t	p a p j U l e t ɨ d
r I p r E s	r I p r E s t
S W R	S W R d
s w u p	s w u p t
t u r	t u r d
w I n s	w I n s t
b Y p æ s	b Y p æ s t
k W n s ɨ l	k W n s ɨ l d
d I t æ C	d I t æ C t
I m p a r t	I m p a r t ɨ d
l o D	l o D d
n i r	n i r d
o v R d u	o v R d I d
p E k	p E k t
p l E J	p l E J d
r I p ɨ l	r I p ɨ l d
s æ l v I J	s æ l v I J d
æ d h i r	æ d h i r d
b æ N k	b æ N k t
b l a t	b l a t ɨ d
k ɨ m p Y l	k ɨ m p Y l d
k r æ k ɨ l	k r æ k ɨ l d
d I d u s	d I d u s t
f ɔ l t R	f ɔ l t R d
h a b ɨ l	h a b ɨ l d
r i k ɨ n s t r ʌ k t	r i k ɨ n s t r ʌ k t ɨ d
s k W l	s k W l d
t æ k s	t æ k s t
ɨ l a t	ɨ l a t ɨ d
k l W d	k l W d ɨ d
d r ʌ m	d r ʌ m d
E l I v e t	E l I v e t ɨ d
g a s I p	g a s I p t
r I f Y n	r I f Y n d
s t r I N	s t r ʌ N
s I m p ɨ T Y z	s I m p ɨ T Y z d
T r a b	T r a b d
t a p ɨ l	t a p ɨ l d
æ k t ɨ v e t	æ k t ɨ v e t ɨ d
b I w I C	b I w I C t
k a l ɨ n Y z	k a l ɨ n Y z d
k ɨ n t æ m I n e t	k ɨ n t æ m I n e t ɨ d
d Y l u t	d Y l u t ɨ d
d I s k ɨ n s R t	d I s k ɨ n s R t ɨ d
f Y n	f Y n d
g l e z	g l e z d
I n k l Y n	I n k l Y n d
I n t I m I d e t	I n t I m I d e t ɨ d
n a m I n e t	n a m I n e t ɨ d
r i l	r i l d
r I n W n s	r I n W n s t
s k r i C	s k r i C t
s l I D R	s l I D R d
s ɨ b s k r Y b	s ɨ b s k r Y b d
t R m	t R m d
k ɨ n t E n t	k ɨ n t E n t ɨ d
k R b	k R b d
I n d E v R	I n d E v R d
f l æ N k	f l æ N k t
f ʌ k	f ʌ k t
l u r	l u r d
n ʌ J	n ʌ J d
p r o l ɔ N	p r o l ɔ N d
s k o l d	s k o l d ɨ d
d I s g ʌ s t	d I s g ʌ s t ɨ d
f l I n C	f l I n C t
f o r t I f Y	f o r t I f Y d
n a t	n a t ɨ d
m æ s k	m æ s k t
W t w e	W t w e d
p R f E k t	p R f E k t ɨ d
p u l	p u l d
s t a r	s t a r d
w u	w u d
b r Y b	b r Y b d
k ɨ l Y d	k ɨ l Y d ɨ d
g r u p	g r u p t
I m p e r	I m p e r d
I n h e l	I n h e l d
I n t R s E p t	I n t R s E p t ɨ d
m ʌ d ɨ l	m ʌ d ɨ l d
o v R t R n	o v R t R n d
p e t r ɨ n Y z	p e t r ɨ n Y z d
p æ t R n	p æ t R n d
s e v R	s e v R d
s t a r C	s t a r C t
s ɨ f Y s	s ɨ f Y s t
t I n	t I n d
w a b ɨ l	w a b ɨ l d
b E l o	b E l o d
f l E k s	f l E k s t
f j u z	f j u z d
I m p a v ɨ r I S	I m p a v ɨ r I S t
n I b ɨ l	n I b ɨ l d
p I k C R	p I k C R d
r I t æ l i e t	r I t æ l i e t ɨ d
ɨ l Y	ɨ l Y d
b l æ k ɨ n	b l æ k ɨ n d
b r I s ɨ l	b r I s ɨ l d
k l ʌ t R	k l ʌ t R d
k O l	k O l d
d I t e n	d I t e n d
d I s p E l	d I s p E l d
g ʌ l p	g ʌ l p t
h æ C	h æ C t
h I C	h I C t
J a s ɨ l	J a s ɨ l d
m a d ɨ l	m a d ɨ l d
p r Y	p r Y d
r I d i m	r I d i m d
r I f r E S	r I f r E S t
T w o r t	T w o r t ɨ d
æ N k R	æ N k R d
k ɨ n s E n t	k ɨ n s E n t ɨ d
k r e v	k r e v d
I l æ b ɨ r e t	I l æ b ɨ r e t ɨ d
f o r g o	f o r w E n t
I n t r u d	I n t r u d ɨ d
l a l	l a l d
m a d R n Y z	m a d R n Y z d
p r a f I t	p r a f I t ɨ d
s p ɔ n	s p ɔ n d
t a t R	t a t R d
C R n	C R n d
I n æ k t	I n æ k t ɨ d
I n g r e v	I n g r e v d
I g z I l ɨ r e t	I g z I l ɨ r e t ɨ d
f r E t	f r E t ɨ d
h æ m p R	h æ m p R d
p r W l	p r W l d
r ʌ f ɨ l	r ʌ f ɨ l d
s k w R m	s k w R m d
b I h o l d	b I h E l d
b Y ɨ s	b Y ɨ s t
b R k	b R k t
k o k s	k o k s t
k ɨ n t E s t	k ɨ n t E s t ɨ d
s n i r	s n i r d
s p Y	s p Y d
s t æ f	s t æ f t
s t o k	s t o k t
s ʌ f ɨ k e t	s ʌ f ɨ k e t ɨ d
t R m I n e t	t R m I n e t ɨ d
ʌ n s E t ɨ l	ʌ n s E t ɨ l d
b I s t o	b I s t o d
b r Y t ɨ n	b r Y t ɨ n d
k ɨ n f l I k t	k ɨ n f l I k t ɨ d
k W n t ɨ r æ k t	k W n t ɨ r æ k t ɨ d
d I s k W n t	d I s k W n t ɨ d
W t n ʌ m b R	W t n ʌ m b R d
s k R i	s k R i d
T æ C	T æ C t
C ʌ k	C ʌ k t
I n k ʌ m p ɨ s	I n k ʌ m p ɨ s t
g r i v	g r i v d
g r u m	g r u m d
h I n d R	h I n d R d
p r I k	p r I k t
r e t	r e t ɨ d
r I f j u t	r I f j u t ɨ d
s i D	s i D d
s I m j U l e t	s I m j U l e t ɨ d
s k R t	s k R t ɨ d
s n o r t	s n o r t ɨ d
s k w ɔ S	s k w ɔ S t
t Y m	t Y m d
w e n	w e n d
b I d	b I d
b r i f	b r i f t
k l æ S	k l æ S t
k l I p	k l I p t
d I s k r E d I t	d I s k r E d I t ɨ d
d I s m e	d I s m e d
f I N g R	f I N g R d
g r æ t I f Y	g r æ t I f Y d
I n v R t	I n v R t ɨ d
m a r	m a r d
m a r v ɨ l	m a r v ɨ l d
m ʌ n C	m ʌ n C t
o v R f l o	o v R f l o d
p o C	p o C t
r I k l e m	r I k l e m d
r I k W n t	r I k W n t ɨ d
s i p	s i p t
s t Y l	s t Y l d
t æ n	t æ n d
w ɔ l	w ɔ l d
w I m p R	w I m p R d
ɨ b Y d	ɨ b Y d ɨ d
ɨ b W n d	ɨ b W n d ɨ d
d I s R n	d I s R n d
d a J	d a J d
I k w e t	I k w e t ɨ d
I g z E m p l ɨ f Y	I g z E m p l ɨ f Y d
f æ t ɨ n	f æ t ɨ n d
f j u ɨ l	f j u ɨ l d
I m R s	I m R s t
Y R n	Y R n d
l ʌ n C	l ʌ n C t
m o	m o d
ʌ n p æ k	ʌ n p æ k t
ɨ m E n d	ɨ m E n d ɨ d
b ʌ n d ɨ l	b ʌ n d ɨ l d
I n v E l ɨ p	I n v E l ɨ p t
g r e t	g r e t ɨ d
h æ v	h æ v d
m æ S	m æ S t
ɨ b l I t ɨ r e t	ɨ b l I t ɨ r e t ɨ d
p W n s	p W n s t
p ʌ t	p ʌ t ɨ d
s E n t	s E n t ɨ d
s k W R	s k W R d
S I p	S I p t
t W R	t W R d
ɨ l i v i e t	ɨ l i v i e t ɨ d
d I f R	d I f R d
d I f l E k t	d I f l E k t ɨ d
d I s I p e t	d I s I p e t ɨ d
f l ʌ k C u e t	f l ʌ k C u e t ɨ d
g l I n t	g l I n t ɨ d
J a g	J a g d
l e s	l e s t
m I m I k	m I m I k t
o v R T r o	o v R T r u
p l æ s t R	p l æ s t R d
p r I k l u d	p r I k l u d ɨ d
r I z Y d	r I z Y d ɨ d
t r ʌ J	t r ʌ J d
k o d	k o d ɨ d
d æ b	d æ b d
f e k	f e k t
f r æ g m E n t	f r æ g m E n t ɨ d
I n t ɨ r æ k t	I n t ɨ r æ k t ɨ d
p æ C	p æ C t
r æ S ɨ n ɨ l Y z	r æ S ɨ n ɨ l Y z d
r I l I N k w I S	r I l I N k w I S t
s t e b ɨ l Y z	s t e b ɨ l Y z d
w æ k s	w æ k s t
w E D R	w E D R d
w i d	w i d ɨ d
b e r	b e r d
d o n e t	d o n e t ɨ d
E k s k ɨ v e t	E k s k ɨ v e t ɨ d
g I l d	g I l d ɨ d
h R d	h R d ɨ d
I m p i d	I m p i d ɨ d
l Y s ɨ n s	l Y s ɨ n s t
m o S ɨ n	m o S ɨ n d
o r d e n	o r d e n d
t e m	t e m d
T r E d	T r E d ɨ d
w E t	w E t
w Y R	w Y R d
k l æ m p	k l æ m p t
k r i s	k r i s t
d a k j U m E n t	d a k j U m E n t ɨ d
I n s R k ɨ l	I n s R k ɨ l d
i r e s	i r e s t
I g z æ s p ɨ r e t	I g z æ s p ɨ r e t ɨ d
n ɔ	n ɔ d
k w o r t R	k w o r t R d
r i ɨ r e n J	r i ɨ r e n J d
r I p E l	r I p E l d
r u t	r u t ɨ d
r ʌ m b ɨ l	r ʌ m b ɨ l d
r ʌ s ɨ l	r ʌ s ɨ l d
s l e	s l u
s k w i l	s k w i l d
s t r i k	s t r i k t
s t Y l Y z	s t Y l Y z d
v W	v W d
k ɨ m E n d	k ɨ m E n d ɨ d
d E f ɨ n	d E f ɨ n d
I l u d	I l u d ɨ d
E m j ɨ l e t	E m j ɨ l e t ɨ d
I n f R	I n f R d
l Y t ɨ n	l Y t ɨ n d
l ʌ m b R	l ʌ m b R d
p ɨ t r o l	p ɨ t r o l d
r i p	r i p t
S r W d	S r W d ɨ d
s p a r k ɨ l	s p a r k ɨ l d
t e l R	t e l R d
t E m p R	t E m p R d
æ g r ɨ v e t	æ g r ɨ v e t ɨ d
I n t r ʌ s t	I n t r ʌ s t ɨ d
I k s p Y R	I k s p Y R d
f R t ɨ l Y z	f R t ɨ l Y z d
g r æ p ɨ l	g r æ p ɨ l d
W t g r o	W t g r u
p ɨ r e d	p ɨ r e d ɨ d
p l e g	p l e g d
r æ S ɨ n	r æ S ɨ n d
s t I C	s t I C t
t e l	t e l d
t I k ɨ l	t I k ɨ l d
t r E Z R	t r E Z R d
w e J	w e J d
d I s p l i z	d I s p l i z d
d a g	d a g d
d r E n C	d r E n C t
f l e v R	f l e v R d
p R v e d	p R v e d ɨ d
p R J	p R J d
S E l v	S E l v d
S r I v ɨ l	S r I v ɨ l d
ɨ d o r n	ɨ d o r n d
ɨ s o r t	ɨ s o r t ɨ d
b ɔ l	b ɔ l d
b l i C	b l i C t
b ʌ k ɨ l	b ʌ k ɨ l d
C a r m	C a r m d
k l i v	k l i v d
i l I s I t	i l I s I t ɨ d
h O s t	h O s t ɨ d
I C	I C t
p r ɨ s I p I t e t	p r ɨ s I p I t e t ɨ d
r æ p	r æ p t
r i k r i e t	r i k r i e t ɨ d
t E n s	t E n s t
t I p t o	t I p t o d
ʌ p d e t	ʌ p d e t ɨ d
æ m p l I f Y	æ m p l I f Y d
b Y s I k ɨ l	b Y s I k ɨ l d
k ɨ n s p Y R	k ɨ n s p Y R d
l æ p s	l æ p s t
p r ɨ p E l	p r ɨ p E l d
r i f I l	r i f I l d
s n o	s n o d
s k w i k	s k w i k t
s t u	s t u d
s w a m p	s w a m p t
k ɨ n v R s	k ɨ n v R s t
d u p l I k e t	d u p l I k e t ɨ d
I k s p E n d	I k s p E n d ɨ d
I n f I l t r e t	I n f I l t r e t ɨ d
I n t e r ɨ g e t	I n t e r ɨ g e t ɨ d
l a b i	l a b i d
l o r d	l o r d ɨ d
n ɨ s E s I t e t	n ɨ s E s I t e t ɨ d
p Y p	p Y p t
r Y ɨ t	r Y ɨ t ɨ d
s æ C R e t	s æ C R e t ɨ d
s k a r	s k a r d
s Y t	s Y t ɨ d
s t æ n d R d Y z	s t æ n d R d Y z d
s w R v	s w R v d
t w I N k ɨ l	t w I N k ɨ l d
ɨ k r u	ɨ k r u d
æ s R t e n	æ s R t e n d
b æ p t Y z	b æ p t Y z d
b I l o	b I l o d
k r I s ɨ n	k r I s ɨ n d
k l a g	k l a g d
k ɨ l æ b ɨ r e t	k ɨ l æ b ɨ r e t ɨ d
k ɨ m E n s	k ɨ m E n s t
k r ʌ n C	k r ʌ n C t
f I J I t	f I J I t ɨ d
I n f j u r i e t	I n f j u r i e t ɨ d
n I p	n I p t
o v R h æ N	o v R h ʌ N
k w I k ɨ n	k w I k ɨ n d
r i k ɨ n s I d R	r i k ɨ n s I d R d
r I g	r I g d
s t ɔ l	s t ɔ l d
s t I N k	s t ʌ N k
s t I N k	s t æ N k
s ɨ b t r æ k t	s ɨ b t r æ k t ɨ d
ʌ n n R v	ʌ n n R v d
æ k s E n C u e t	æ k s E n C u e t ɨ d
C e r	C e r d
k ɨ n d E n s	k ɨ n d E n s t
k r I s t ɨ l Y z	k r I s t ɨ l Y z d
k ʌ p	k ʌ p t
d I k r i	d I k r i d
d I p l i t	d I p l i t ɨ d
d I s s æ t I s f Y	d I s s æ t I s f Y d
h ʌ m p	h ʌ m p t
I n s t I t u S ɨ n ɨ l Y z	I n s t I t u S ɨ n ɨ l Y z d
J æ b	J æ b d
p æ d ɨ l	p æ d ɨ l d
r ʌ m I J	r ʌ m I J d
s ɔ l t	s ɔ l t ɨ d
s k o r n	s k o r n d
S i r	S i r d
S E l	S E l d
s I f t	s I f t ɨ d
s l æ k ɨ n	s l æ k ɨ n d
ɨ p i z	ɨ p i z d
b æ b ɨ l	b æ b ɨ l d
k ɨ n s t r e n	k ɨ n s t r e n d
k r i m	k r i m d
d ɔ n t	d ɔ n t ɨ d
d I s p e r	d I s p e r d
d ɨ m E s t I k e t	d ɨ m E s t I k e t ɨ d
I n S u r	I n S u r d
l æ p	l æ p t
m ɨ s a Z	m ɨ s a Z d
p I n p O n t	p I n p O n t ɨ d
p l Y	p l Y d
r I t o r t	r I t o r t ɨ d
s ʌ l k	s ʌ l k t
s R f I s	s R f I s t
v ɔ l t	v ɔ l t ɨ d
ɨ n O n t	ɨ n O n t ɨ d
b æ s k	b æ s k t
b l æ k m e l	b l æ k m e l d
I g z æ s R b e t	I g z æ s R b e t ɨ d
g r I m ɨ s	g r I m ɨ s t
I m p r I n t	I m p r I n t ɨ d
I n t R l a k	I n t R l a k t
O l	O l d
o v R l o d	o v R l o d ɨ d
p ʌ N k C u e t	p ʌ N k C u e t ɨ d
r I k l Y n	r I k l Y n d
s k r u t I n Y z	s k r u t I n Y z d
s n o r	s n o r d
w æ g	w æ g d
k ɨ n d o n	k ɨ n d o n d
d r æ m ɨ t Y z	d r æ m ɨ t Y z d
f e n	f e n d
f a n d ɨ l	f a n d ɨ l d
J E p R d Y z	J E p R d Y z d
m Y n	m Y n d
m j u t I l e t	m j u t I l e t ɨ d
u z	u z d
p r a f R	p r a f R d
r i J O n	r i J O n d
r E v ɨ l u S ɨ n Y z	r E v ɨ l u S ɨ n Y z d
r i r Y t	r i r o t
s ɔ n t R	s ɔ n t R d
v e r I f Y	v e r I f Y d
v Y	v Y d
ɔ g m E n t	ɔ g m E n t ɨ d
b æ S	b æ S t
b l ʌ n d R	b l ʌ n d R d
b r E k f ɨ s t	b r E k f ɨ s t ɨ d
b r E s t f i d	b r E s t f E d
k a n J R	k a n J R d
d E v ɨ s t e t	d E v ɨ s t e t ɨ d
f r I n J	f r I n J d
h e r ɨ l d	h e r ɨ l d ɨ d
J i r	J i r d
n u t r ɨ l Y z	n u t r ɨ l Y z d
p E t r I f Y	p E t r I f Y d
p r Y z	p r Y z d
r i s t r ʌ k C R	r i s t r ʌ k C R d
r I v i r	r I v i r d
r I d ɨ l	r I d ɨ l d
s k ʌ t ɨ l	s k ʌ t ɨ l d
s p Y r ɨ l	s p Y r ɨ l d
s w I v ɨ l	s w I v ɨ l d
t e p R	t e p R d
t o	t o d
w R s ɨ n	w R s ɨ n d
b æ n d I J	b æ n d I J d
k æ m ɨ f l a Z	k æ m ɨ f l a Z d
C a r t R	C a r t R d
d I v R s I f Y	d I v R s I f Y d
I n r o l	I n r o l d
f l e k	f l e k t
f l R t	f l R t ɨ d
g e J	g e J d
I m p r ɨ v Y z	I m p r ɨ v Y z d
m æ s	m æ s t
m æ s t R b e t	m æ s t R b e t ɨ d
m I n s	m I n s t
ɨ b s t r ʌ k t	ɨ b s t r ʌ k t ɨ d
p I s	p I s t
k j u	k j u d
s m o l d R	s m o l d R d
t æ t u	t æ t u d
w u p	w u p t
ɨ b s t e n	ɨ b s t e n d
b I f ɔ l	b I f E l
k r e d ɨ l	k r e d ɨ l d
k ʌ d ɨ l	k ʌ d ɨ l d
d I m o r ɨ l Y z	d I m o r ɨ l Y z d
f i s t	f i s t ɨ d
h a r b R	h a r b R d
h ʌ s ɨ l	h ʌ s ɨ l d
l u t	l u t ɨ d
m e l	m e l d
p W R	p W R d
r æ k	r æ k t
s p æ n	s p æ n d
t o s t	t o s t ɨ d
ʌ n l i S	ʌ n l i S t
v O s	v O s t
ɨ s æ s I n e t	ɨ s æ s I n e t ɨ d
b l u m	b l u m d
I n k e s	I n k e s t
I n t Y s	I n t Y s t
h Y k	h Y k t
h a l R	h a l R d
h j u m R	h j u m R d
I n s k r Y b	I n s k r Y b d
m æ p	m æ p t
p i p	p i p t
p r ɨ f E s	p r ɨ f E s t
p R s	p R s t
r i k æ p C R	r i k æ p C R d
r I p r o C	r I p r o C t
s æ d ɨ l	s æ d ɨ l d
s R v I s	s R v I s t
s p e s	s p e s t
s ɨ p l æ n t	s ɨ p l æ n t ɨ d
a r t I k j U l e t	a r t I k j U l e t ɨ d
b I s E t	b I s E t
b r I J	b r I J d
s E n s R	s E n s R d
k l æ s	k l æ s t
k a m p l I m E n t	k a m p l I m E n t ɨ d
k R t e l	k R t e l d
d Y ɨ t	d Y ɨ t ɨ d
d r I b ɨ l	d r I b ɨ l d
g æ m b ɨ l	g æ m b ɨ l d
g a b ɨ l	g a b ɨ l d
m E m ɨ r Y z	m E m ɨ r Y z d
m e r I t	m e r I t ɨ d
m I t I g e t	m I t I g e t ɨ d
p R s I k j u t	p R s I k j u t ɨ d
p l a d	p l a d ɨ d
r Y p ɨ n	r Y p ɨ n d
s k e l	s k e l d
s k r æ p	s k r æ p t
S r E d	S r E d ɨ d
s t ʌ n t	s t ʌ n t ɨ d
t æ g	t æ g d
t e p	t e p t
t e r ɨ s	t e r ɨ s t
t E D R	t E D R d
k æ p	k æ p t
k r u s I f Y	k r u s I f Y d
f o r s t ɔ l	f o r s t ɔ l d
I n t o n	I n t o n d
l æ g	l æ g d
l i C	l i C t
l W n J	l W n J d
m Y g r e t	m Y g r e t ɨ d
p e r ɨ l E l	p e r ɨ l E l d
r ʌ m p ɨ l	r ʌ m p ɨ l d
s æ N k S ɨ n	s æ N k S ɨ n d
s ɔ	s ɔ d
s p R	s p R d
s ɨ b m R J	s ɨ b m R J d
ɔ t o m e t	ɔ t o m e t ɨ d
b r W n	b r W n d
b ʌ g R	b ʌ g R d
d I d ʌ k t	d I d ʌ k t ɨ d
d I s l a J	d I s l a J d
I n J E n d R	I n J E n d R d
I g z o r t	I g z o r t ɨ d
E k s Y l	E k s Y l d
g ʌ t	g ʌ t ɨ d
I m p l æ n t	I m p l æ n t ɨ d
n ʌ m	n ʌ m d
r i o r g ɨ n Y z	r i o r g ɨ n Y z d
s k o r C	s k o r C t
s I n	s I n d
s p a r k	s p a r k t
ʌ n r æ v ɨ l	ʌ n r æ v ɨ l d
ɨ k w I t	ɨ k w I t ɨ d
k æ p I t ɨ l Y z	k æ p I t ɨ l Y z d
I J E k t	I J E k t ɨ d
I m æ n s I p e t	I m æ n s I p e t ɨ d
I n g r o s	I n g r o s t
I v æ k j u e t	I v æ k j u e t ɨ d
f U t	f U t ɨ d
g l W R	g l W R d
I m p l o r	I m p l o r d
l u p	l u p t
m E d I t e t	m E d I t e t ɨ d
p R s I v i r	p R s I v i r d
p r I d a m I n e t	p r I d a m I n e t ɨ d
r i o p ɨ n	r i o p ɨ n d
r I d I k j u l	r I d I k j u l d
s ɨ l u t	s ɨ l u t ɨ d
S æ d o	S æ d o d
s l I t	s l I t
s o S ɨ l Y z	s o S ɨ l Y z d
s p l I n t R	s p l I n t R d
s u p R s i d	s u p R s i d ɨ d
t Y l	t Y l d
t r æ n s p Y R	t r æ n s p Y R d
w E l	w E l d
b E l C	b E l C t
b ʌ k	b ʌ k t
b ʌ n C	b ʌ n C t
k l æ m R	k l æ m R d
k l E n z	k l E n z d
d I s t r ʌ s t	d I s t r ʌ s t ɨ d
d r ʌ g	d r ʌ g d
I n f l e t	I n f l e t ɨ d
J ʌ m b ɨ l	J ʌ m b ɨ l d
l ʌ n J	l ʌ n J d
m j u z	m j u z d
f r e z	f r e z d
p r e	p r e d
p R	p R d
r æ m	r æ m d
s æ d ɨ n	s æ d ɨ n d
s k I d	s k I d ɨ d
s t ʌ d	s t ʌ d ɨ d
t r Y ɨ m f	t r Y ɨ m f t
ɨ v E n J	ɨ v E n J d
b r e k	b r e k t
d I l u d	d I l u d ɨ d
d I n o t	d I n o t ɨ d
d ʌ b	d ʌ b d
I n t æ N g ɨ l	I n t æ N g ɨ l d
I g z u d	I g z u d ɨ d
h E J	h E J d
p I k ɨ l	p I k ɨ l d
r E l I g e t	r E l I g e t ɨ d
r i p l e	r i p l e d
s k ɔ f	s k ɔ f t
s m Y t	s m o t
s n i z	s n i z d
t O l	t O l d
t o t ɨ l	t o t ɨ l d
t w R l	t w R l d
w o r ɨ n t	w o r ɨ n t ɨ d
æ N g ɨ l	æ N g ɨ l d
b E d	b E d ɨ d
s I m E n t	s I m E n t ɨ d
k ɨ m E m ɨ r e t	k ɨ m E m ɨ r e t ɨ d
k ɨ m p j u t R Y z	k ɨ m p j u t R Y z d
k a n	k a n d
d I s ɨ b e	d I s ɨ b e d
I k s t I N g w I S	I k s t I N g w I S t
f l æ g	f l æ g d
g r W n d	g r W n d ɨ d
m i r R	m i r R d
n E s ɨ l	n E s ɨ l d
p I t	p I t ɨ d
p W t	p W t ɨ d
k w i r i	k w i r i d
r I b j u k	r I b j u k t
r o	r o d
s æ m p ɨ l	s æ m p ɨ l d
s I k r i t	s I k r i t ɨ d
S ʌ n	S ʌ n d
s k I n	s k I n d
s k w a n d R	s k w a n d R d
s ɨ b d u	s ɨ b d u d
t I N g ɨ l	t I N g ɨ l d
ʌ p r u t	ʌ p r u t ɨ d
v i r	v i r d
w o r p	w o r p t
b l a s ɨ m	b l a s ɨ m d
b R d ɨ n	b R d ɨ n d
b R o	b R o d
b ʌ s t	b ʌ s t ɨ d
b I z i	b I z i d
k e b ɨ l	k e b ɨ l d
k æ s t r e t	k æ s t r e t ɨ d
k l æ N	k l æ N d
k O n	k O n d
k a n d I s E n d	k a n d I s E n d ɨ d
k o r n R	k o r n R d
k o r ɨ l e t	k o r ɨ l e t ɨ d
d I p o r t	d I p o r t ɨ d
d I m	d I m d
d I v Y n	d I v Y n d
i l ɔ N g e t	i l ɔ N g e t ɨ d
I r æ d ɨ k e t	I r æ d ɨ k e t ɨ d
f l I t	f l I t ɨ d
f o r I J	f o r I J d
h u t	h u t ɨ d
Y s	Y s t
I m p E l	I m p E l d
I m p l I k e t	I m p l I k e t ɨ d
J o l t	J o l t ɨ d
m E d ɨ l	m E d ɨ l d
W t l ɔ	W t l ɔ d
p a r C	p a r C t
p a r d ɨ n	p a r d ɨ n d
r I v o l t	r I v o l t ɨ d
s k w R t	s k w R t ɨ d
s t æ m R	s t æ m R d
s t o	s t o d
s R p æ s	s R p æ s t
t i D	t i D d
t I N k ɨ l	t I N k ɨ l d
w Y t w ɔ S	w Y t w ɔ S t
C Y m	C Y m d
k a n f I s k e t	k a n f I s k e t ɨ d
k ɨ n t o r t	k ɨ n t o r t ɨ d
d æ m p ɨ n	d æ m p ɨ n d
E m I g r e t	E m I g r e t ɨ d
I n t r æ n s	I n t r æ n s t
I k s E l	I k s E l d
f l a k	f l a k t
f o r f I t	f o r f I t ɨ d
J e l	J e l d
l ɨ m E n t	l ɨ m E n t ɨ d
m E k ɨ n Y z	m E k ɨ n Y z d
m o r	m o r d
o r i ɨ n t	o r i ɨ n t ɨ d
p E d ɨ l	p E d ɨ l d
p i n ɨ l Y z	p i n ɨ l Y z d
p r o t r æ k t	p r o t r æ k t ɨ d
s t e r i o t Y p	s t e r i o t Y p t
s t r ʌ t	s t r ʌ t ɨ d
b I s i J	b I s i J d
b r W z	b r W z d
k r o	k r o d
I k s p W n d	I k s p W n d ɨ d
f l W n d R	f l W n d R d
f r æ k C R	f r æ k C R d
g æ g	g æ g d
g a r d ɨ n	g a r d ɨ n d
g R g ɨ l	g R g ɨ l d
g ʌ S	g ʌ S t
Y d i ɨ l Y z	Y d i ɨ l Y z d
I n d Y t	I n d Y t ɨ d
m i d i e t	m i d i e t ɨ d
p l e k e t	p l e k e t ɨ d
p j U r I f Y	p j U r I f Y d
r æ v I J	r æ v I J d
r i l e	r i l e d
r I t r æ k t	r I t r æ k t ɨ d
T ɔ	T ɔ d
t r ɨ v R s	t r ɨ v R s t
w I l t	w I l t ɨ d
ɨ l Y t	ɨ l Y t ɨ d
b r æ n C	b r æ n C t
d i J E n R e t	d i J E n R e t ɨ d
d I s t I l	d I s t I l d
E C	E C t
f W l	f W l d
m ɔ l	m ɔ l d
m I s t I f Y	m I s t I f Y d
n ɔ z i e t	n ɔ z i e t ɨ d
o v R r Y d	o v R r o d
p R m i e t	p R m i e t ɨ d
p I k I t	p I k I t ɨ d
p I t i	p I t i d
p r i s ɨ p o z	p r i s ɨ p o z d
r E m ɨ d i	r E m ɨ d i d
r ʌ s t	r ʌ s t ɨ d
s k r æ b ɨ l	s k r æ b ɨ l d
s p u n	s p u n d
s R m W n t	s R m W n t ɨ d
j u r I n e t	j u r I n e t ɨ d
b e l	b e l d
b r æ n d	b r æ n d ɨ d
k a r t	k a r t ɨ d
k l a t	k l a t ɨ d
g l u	g l u d
h I n J	h I n J d
n i d	n i d ɨ d
m o t R	m o t R d
o v R S æ d o	o v R S æ d o d
r i d I s t r I b j u t	r i d I s t r I b j u t ɨ d
r i l I v	r i l I v d
r I p i l	r I p i l d
r I p j u d i e t	r I p j u d i e t ɨ d
S o l d R	S o l d R d
t r æ m p	t r æ m p t
t r u p	t r u p t
t r ʌ n d ɨ l	t r ʌ n d ɨ l d
ʌ n v e l	ʌ n v e l d
w a l o	w a l o d
æ p r I h E n d	æ p r I h E n d ɨ d
ɨ p r o p r i e t	ɨ p r o p r i e t ɨ d
k ɨ n f W n d	k ɨ n f W n d ɨ d
d I s Y f R	d I s Y f R d
d I s ɨ p O n t	d I s ɨ p O n t ɨ d
I l æ p s	I l æ p s t
e r	e r d
f e r	f e r d
f R m E n t	f R m E n t ɨ d
f r e	f r e d
g a l f	g a l f t
I n s t I l	I n s t I l d
I n t R s p R s	I n t R s p R s t
l o	l o d
p E g	p E g d
s k æ m p R	s k æ m p R d
s I n T ɨ s Y z	s I n T ɨ s Y z d
t r æ n s p l æ n t	t r æ n s p l æ n t ɨ d
ɨ s e l	ɨ s e l d
b o l s t R	b o l s t R d
b O k a t	b O k a t ɨ d
b r e d	b r e d ɨ d
k ɨ m j u t	k ɨ m j u t ɨ d
k o r ɨ g e t	k o r ɨ g e t ɨ d
d æ m p	d æ m p t
f l ɔ n t	f l ɔ n t ɨ d
l O t R	l O t R d
l ʌ l	l ʌ l d
m ʌ D R	m ʌ D R d
p e r	p e r d
p R v R t	p R v R t ɨ d
p a k I t	p a k I t ɨ d
r E k ɨ l E k t	r E k ɨ l E k t ɨ d
r i d r E s	r i d r E s t
r u m R	r u m R d
s Y t	s Y t ɨ d
s Y z	s Y z d
s l æ n t	s l æ n t ɨ d
s l a p	s l a p t
s p æ t R	s p æ t R d
s t r æ d ɨ l	s t r æ d ɨ l d
t e r ɨ r Y z	t e r ɨ r Y z d
ʌ n J u l e t	ʌ n J u l e t ɨ d
b r e n w ɔ S	b r e n w ɔ S t
b r I m	b r I m d
b U C R	b U C R d
C a r	C a r d
k ʌ l	k ʌ l d
d i s E n t r ɨ l Y z	d i s E n t r ɨ l Y z d
d I f j u z	d I f j u z d
d I s g r e s	d I s g r e s t
I m b I t R	I m b I t R d
I m p W R	I m p W R d
f o r k	f o r k t
f o r m ɨ l Y z	f o r m ɨ l Y z d
f r I k w E n t	f r I k w E n t ɨ d
I n s t ɨ t u t	I n s t ɨ t u t ɨ d
l E v i	l E v i d
l o k ɨ l Y z	l o k ɨ l Y z d
p o l ɨ r Y z	p o l ɨ r Y z d
p r o l I f R e t	p r o l I f R e t ɨ d
r i ɨ f R m	r i ɨ f R m d
r i s R C	r i s R C t
s p r I n t	s p r I n t ɨ d
s t ʌ m p	s t ʌ m p t
s w i t ɨ n	s w i t ɨ n d
T r E S	T r E S t
t I n J	t I n J d
ʌ n r o l	ʌ n r o l d
j u s R p	j u s R p t
v E t	v E t ɨ d
æ m b U S	æ m b U S t
b a m b a r d	b a m b a r d ɨ d
d E l I g e t	d E l I g e t ɨ d
d I s E m I n e t	d I s E m I n e t ɨ d
I n l Y t ɨ n	I n l Y t ɨ n d
I n l Y v ɨ n	I n l Y v ɨ n d
f E D R	f E D R d
f ɨ l e	f ɨ l e d
f l e l	f l e l d
g æ s	g æ s t
g l o r I f Y	g l o r I f Y d
I n k r I m I n e t	I n k r I m I n e t ɨ d
I n t R t w Y n	I n t R t w Y n d
l E J I s l e t	l E J I s l e t ɨ d
m e m	m e m d
m a d ɨ r e t	m a d ɨ r e t ɨ d
o v R E s t I m e t	o v R E s t I m e t ɨ d
p l ʌ m p	p l ʌ m p t
p R p o r t	p R p o r t ɨ d
s k e t	s k e t ɨ d
s t i l	s t i l d
t r I k	t r I k t
v e k e t	v e k e t ɨ d
w a f t	w a f t ɨ d
w i z	w i z d
j æ N k	j æ N k t
ɔ	ɔ d
b I l I t ɨ l	b I l I t ɨ l d
b I l	b I l d
b ʌ J	b ʌ J d
b ʌ t R	b ʌ t R d
k r I n J	k r I n J d
d I s p r u v	d I s p r u v d
d I s w e d	d I s w e d ɨ d
d w o r f	d w o r f t
I v I k t	I v I k t ɨ d
h ɔ k	h ɔ k t
J I N g ɨ l	J I N g ɨ l d
J a t	J a t ɨ d
p E n	p E n d
r i J E n R e t	r i J E n R e t ɨ d
r i I t ɨ r e t	r i I t ɨ r e t ɨ d
r I p E n t	r I p E n t ɨ d
s k r ɔ l	s k r ɔ l d
S ʌ v ɨ l	S ʌ v ɨ l d
s p o r t	s p o r t ɨ d
s t ʌ b	s t ʌ b d
t i t R	t i t R d
T ʌ d	T ʌ d ɨ d
t I p I f Y	t I p I f Y d
ɨ v e l	ɨ v e l d
b l æ n C	b l æ n C t
b ɔ s	b ɔ s t
k ɨ J o l	k ɨ J o l d
k ɨ n k a k t	k ɨ n k a k t ɨ d
k ɨ n s t r I k t	k ɨ n s t r I k t ɨ d
k u	k u d
I n k r ʌ s t	I n k r ʌ s t ɨ d
E k s h e l	E k s h e l d
f e r i	f e r i d
f r ɔ s t	f r ɔ s t ɨ d
J E s t I k j U l e t	J E s t I k j U l e t ɨ d
g r e	g r e d
h i d	h i d ɨ d
I n t R	I n t R d
l i s	l i s t
W t s t r I p	W t s t r I p t
o v R r ʌ n	o v R r æ n
p E t	p E t ɨ d
p W d R	p W d R d
r æ t I f Y	r æ t I f Y d
r i k	r i k t
s ɨ l I s I t	s ɨ l I s I t ɨ d
s t e k	s t e k t
s u p ɨ r I m p o z	s u p ɨ r I m p o z d
t a r n I S	t a r n I S t
t I N k R	t I N k R d
ʌ n R T	ʌ n R T t
ʌ p	ʌ p t
v E n t	v E n t ɨ d
ɨ d I k t	ɨ d I k t ɨ d
b R J ɨ n	b R J ɨ n d
k l æ N k	k l æ N k t
k a b ɨ l	k a b ɨ l d
k a n s I k r e t	k a n s I k r e t ɨ d
k ɨ n s Y n	k ɨ n s Y n d
E n J I n i r	E n J I n i r d
i k w ɨ l Y z	i k w ɨ l Y z d
E v I d ɨ n s	E v I d ɨ n s t
f E n s	f E n s t
f l ɔ	f l ɔ d
I n s Y t	I n s Y t ɨ d
l ʌ g	l ʌ g d
m E z m ɨ r Y z	m E z m ɨ r Y z d
n ʌ z ɨ l	n ʌ z ɨ l d
o r i E n t e t	o r i E n t e t ɨ d
p i k	p i k t
p o l	p o l d
p r a p ɨ g e t	p r a p ɨ g e t ɨ d
p r u n	p r u n d
r o v	r o v d
S æ N h Y	S æ N h Y d
s I k ɨ n	s I k ɨ n d
v æ l I d e t	v æ l I d e t ɨ d
ɨ l Y n	ɨ l Y n d
ɨ s w e J	ɨ s w e J d
b ʌ t	b ʌ t ɨ d
C E k R	C E k R d
k ɨ n v i n	k ɨ n v i n d
d a r n	d a r n d
d e d r i m	d e d r i m d
d ʌ l	d ʌ l d
I n S r Y n	I n S r Y n d
f o r t E l	f o r t o l d
g W J	g W J d
h o r d	h o r d ɨ d
h ɔ N k	h ɔ N k t
l u s	l u s t
m I s p l e s	m I s p l e s t
W t w I t	W t w I t ɨ d
o v R s i	o v R s ɔ
p r ɨ k j u r	p r ɨ k j u r d
r E v ɨ l	r E v ɨ l d
s o b R	s o b R d
s p æ N k	s p æ N k t
s p R n	s p R n d
ʌ n s k r u	ʌ n s k r u d
z I p	z I p t
ɨ n Y ɨ l e t	ɨ n Y ɨ l e t ɨ d
b l e r	b l e r d
b r o C	b r o C t
k a N g r ɨ g e t	k a N g r ɨ g e t ɨ d
k U S ɨ n	k U S ɨ n d
d æ b ɨ l	d æ b ɨ l d
d I b e s	d I b e s t
d i r e n J	d i r e n J d
d I s f I g j R	d I s f I g j R d
I s p W z	I s p W z d
f æ D ɨ m	f æ D ɨ m d
f ɔ l t	f ɔ l t ɨ d
m ɨ n a p ɨ l Y z	m ɨ n a p ɨ l Y z d
p i	p i d
p ʌ l s	p ʌ l s t
r E d ɨ n	r E d ɨ n d
r i j u n Y t	r i j u n Y t ɨ d
r i v Y t ɨ l Y z	r i v Y t ɨ l Y z d
s n I g R	s n I g R d
s p Y s	s p Y s t
t æ k	t æ k t
t o l	t o l d
w e t	w e t ɨ d
ɨ b e t	ɨ b e t ɨ d
ɨ J O n	ɨ J O n d
æ m b ɨ l	æ m b ɨ l d
ɨ p r a k s I m e t	ɨ p r a k s I m e t ɨ d
b e t	b e t ɨ d
k W R	k W R d
d ɔ d ɨ l	d ɔ d ɨ l d
d I f Y l	d I f Y l d
I n æ m ɨ l	I n æ m ɨ l d
f j u m	f j u m d
g æ l v ɨ n Y z	g æ l v ɨ n Y z d
h ɔ s p I t ɨ l Y z	h ɔ s p I t ɨ l Y z d
h j u m ɨ n Y z	h j u m ɨ n Y z d
I n t ɨ r I l e t	I n t ɨ r I l e t ɨ d
I n t a k s I k e t	I n t a k s I k e t ɨ d
n Y f	n Y f t
m ʌ k	m ʌ k t
p R t R b	p R t R b d
p a s C ɨ l e t	p a s C ɨ l e t ɨ d
p r a f I s Y	p r a f I s Y d
r I p l E n I S	r I p l E n I S t
s æ b ɨ t a Z	s æ b ɨ t a Z d
S æ k ɨ l	S æ k ɨ l d
S I t	S I t ɨ d
S ʌ n t	S ʌ n t ɨ d
s I z ɨ l	s I z ɨ l d
s l a t	s l a t ɨ d
s n e k	s n e k t
T ʌ m	T ʌ m d
t I n t	t I n t ɨ d
w e k ɨ n	w e k ɨ n d
w I t ɨ l	w I t ɨ l d
j E l o	j E l o d
ɨ m æ l g ɨ m e t	ɨ m æ l g ɨ m e t ɨ d
b e	b e d
b r æ n d I S	b r æ n d I S t
k e k	k e k t
k a r p I t	k a r p I t ɨ d
k ɔ S ɨ n	k ɔ S ɨ n d
k l I n C	k l I n C t
k ɨ n J E k C R	k ɨ n J E k C R d
k ʌ v I t	k ʌ v I t ɨ d
k ʌ f	k ʌ f t
d I b I l I t e t	d I b I l I t e t ɨ d
d I p r e v	d I p r e v d
d Y l e t	d Y l e t ɨ d
d I s k ʌ l R	d I s k ʌ l R d
d I s E k t	d I s E k t ɨ d
I l E k t r I f Y	I l E k t r I f Y d
I n k r o C	I n k r o C t
I k s t R m I n e t	I k s t R m I n e t ɨ d
f l a g	f l a g d
f o m	f o m d
g l I m R	g l I m R d
g o d	g o d ɨ d
I n C	I n C t
I n t R J E k t	I n t R J E k t ɨ d
J æ N g ɨ l	J æ N g ɨ l d
k I n d ɨ l	k I n d ɨ l d
m æ d ɨ n	m æ d ɨ n d
m O s ɨ n	m O s ɨ n d
o r k I s t r e t	o r k I s t r e t ɨ d
W s t	W s t ɨ d
o v R w R k	o v R w R k t
p e v	p e v d
r æ n t	r æ n t ɨ d
r i m e r i	r i m e r i d
s W R	s W R d
s p j u	s p j u d
s p l ʌ t R	s p l ʌ t R d
s t a m p	s t a m p t
t æ k s i	t æ k s i d
t r E b ɨ l	t r E b ɨ l d
v i t o	v i t o d
æ b d I k e t	æ b d I k e t ɨ d
b æ n d	b æ n d ɨ d
k æ t ɨ l ɔ g	k æ t ɨ l ɔ g d
k ɨ n s t r u	k ɨ n s t r u d
k r o k	k r o k t
d I l I b R e t	d I l I b R e t ɨ d
d I s m W n t	d I s m W n t ɨ d
f o r s e k	f o r s U k
h o	h o d
I n f l e m	I n f l e m d
J R n i	J R n i d
m a r S ɨ l	m a r S ɨ l d
n E s t	n E s t ɨ d
p æ m p R	p æ m p R d
p R s ɨ n ɨ l Y z	p R s ɨ n ɨ l Y z d
p r æ n s	p r æ n s t
p r E S R	p r E S R d
r e v	r e v d
S e m	S e m d
S ʌ t R	S ʌ t R d
s ʌ k ɨ l	s ʌ k ɨ l d
t e n t	t e n t ɨ d
t æ n t ɨ l Y z	t æ n t ɨ l Y z d
ʌ p h o l s t R	ʌ p h o l s t R d
ɨ b h o r	ɨ b h o r d
ɨ m æ s	ɨ m æ s t
b l ʌ f	b l ʌ f t
C e f	C e f t
k ɨ n k R	k ɨ n k R d
k a p j U l e t	k a p j U l e t ɨ d
k ɨ r a b ɨ r e t	k ɨ r a b ɨ r e t ɨ d
k r æ m p	k r æ m p t
d I f l e t	d I f l e t ɨ d
d a m I n i r	d a m I n i r d
I g z æ k t	I g z æ k t ɨ d
g o r J	g o r J d
g r æ f t	g r æ f t ɨ d
I n s t I g e t	I n s t I g e t ɨ d
J ʌ g ɨ l	J ʌ g ɨ l d
l i g ɨ l Y z	l i g ɨ l Y z d
l ʌ m p	l ʌ m p t
m o r g I J	m o r g I J d
n E k	n E k t
p E l t	p E l t ɨ d
p R s p Y R	p R s p Y R d
p l ʌ n d R	p l ʌ n d R d
r I k O l	r I k O l d
r E z ɨ r E k t	r E z ɨ r E k t ɨ d
r E C	r E C t
s k æ n d ɨ l Y z	s k æ n d ɨ l Y z d
s Y d ɨ l	s Y d ɨ l d
s m R k	s m R k t
s ɨ l I d I f Y	s ɨ l I d I f Y d
s t ʌ t R	s t ʌ t R d
s R m Y z	s R m Y z d
t E l I v Y z	t E l I v Y z d
t w I t R	t w I t R d
ʌ n z I p	ʌ n z I p t
ɨ l e	ɨ l e d
b I f r E n d	b I f r E n d ɨ d
b I g E t	b I g a t
b l ʌ n t	b l ʌ n t ɨ d
k r e n	k r e n d
d I f E k t	d I f E k t ɨ d
d E n I g r e t	d E n I g r e t ɨ d
d I s k ɨ n t I n j u	d I s k ɨ n t I n j u d
d I s p e r I J	d I s p e r I J d
d Y v ʌ l J	d Y v ʌ l J d
I n s l e v	I n s l e v d
f ɔ l s ɨ f Y	f ɔ l s ɨ f Y d
f l W R	f l W R d
f ɔ s I l Y z	f ɔ s I l Y z d
g l i n	g l i n d
i r I g e t	i r I g e t ɨ d
l æ n s k e p	l æ n s k e p t
l ɔ n d R	l ɔ n d R d
l i r	l i r d
l o n	l o n d
m æ s k ɨ r e d	m æ s k ɨ r e d ɨ d
p æ n ɨ l	p æ n ɨ l d
p æ t R	p æ t R d
p R p I t r e t	p R p I t r e t ɨ d
p E s t R	p E s t R d
r æ n s æ k	r æ n s æ k t
r i n e m	r i n e m d
r W t	r W t ɨ d
s E g r I g e t	s E g r I g e t ɨ d
s n ʌ g ɨ l	s n ʌ g ɨ l d
s p ʌ n J	s p ʌ n J d
s ɨ b o r d I n e t	s ɨ b o r d I n e t ɨ d
s w ɔ D	s w ɔ D d
T r ɔ N	T r ɔ N d
w o r	w o r d
w E J	w E J d
w R	w R d
w I z	w I z d
ɨ f r ʌ n t	ɨ f r ʌ n t ɨ d
b a n d	b a n d ɨ d
C ʌ g	C ʌ g d
d I l i t	d I l i t ɨ d
d I s b æ n d	d I s b æ n d ɨ d
d I s k ɨ n E k t	d I s k ɨ n E k t ɨ d
d I s o r g ɨ n Y z	d I s o r g ɨ n Y z d
d I s k w Y ɨ t	d I s k w Y ɨ t ɨ d
d Y v R J	d Y v R J d
d W s	d W s t
d r o n	d r o n d
E b	E b d
I k l I p s	I k l I p s t
I g z E m p t	I g z E m p t ɨ d
f E s t R	f E s t R d
f l ʌ s t R	f l ʌ s t R d
h E k t R	h E k t R d
I n t R n	I n t R n d
l i f	l i f t
l I k w I d e t	l I k w I d e t ɨ d
m W D	m W D d
o v R s I m p l I f Y	o v R s I m p l I f Y d
p R s a n I f Y	p R s a n I f Y d
r E k t I f Y	r E k t I f Y d
r i f j u ɨ l	r i f j u ɨ l d
s n ʌ f	s n ʌ f t
s t I p j U l e t	s t I p j U l e t ɨ d
t ɔ n t	t ɔ n t ɨ d
t w I d ɨ l	t w I d ɨ l d
ʌ p g r e d	ʌ p g r e d ɨ d
r E s t	r E s t ɨ d
æ k s i d	æ k s i d ɨ d
ɨ k l e m	ɨ k l e m d
b æ N k w I t	b æ N k w I t ɨ d
b e s t	b e s t ɨ d
b ʌ m b ɨ l	b ʌ m b ɨ l d
k æ t ɨ g R Y z	k æ t ɨ g R Y z d
k a m p l I m E n t	k a m p l I m E n t ɨ d
k r u n	k r u n d
k R d ɨ l	k R d ɨ l d
d i f j u z	d i f j u z d
d E t ɨ n e t	d E t ɨ n e t ɨ d
d I s b I l i v	d I s b I l i v d
d I s m E m b R	d I s m E m b R d
d I s k w a l I f Y	d I s k w a l I f Y d
d I s t E n d	d I s t E n d ɨ d
i r m a r k	i r m a r k t
E k s t o l	E k s t o l d
f l u t	f l u t ɨ d
f r ʌ n t	f r ʌ n t ɨ d
g a r n I S	g a r n I S t
h a r k	h a r k t
h W n d	h W n d ɨ d
I g n Y t	I g n Y t ɨ d
I m p r E g n e t	I m p r E g n e t ɨ d
I n f E s t	I n f E s t ɨ d
J a r	J a r d
l æ N g w I S	l æ N g w I S t
o r b I t	o r b I t ɨ d
a s I l e t	a s I l e t ɨ d
p ʌ l s e t	p ʌ l s e t ɨ d
k w E l	k w E l d
r i v R b R e t	r i v R b R e t ɨ d
s k ʌ f	s k ʌ f t
s E g m E n t	s E g m E n t ɨ d
s l a S	s l a S t
s l W C	s l W C t
s ʌ b v R t	s ʌ b v R t ɨ d
ɨ b r i v i e t	ɨ b r i v i e t ɨ d
ɨ b o r t	ɨ b o r t ɨ d
ɨ b z a l v	ɨ b z a l v d
æ d m a n I S	æ d m a n I S t
b æ g	b æ g d
b I f I t	b I f I t ɨ d
b I l Y	b I l Y d
b l i t	b l i t ɨ d
k e J	k e J d
k W C	k W C t
k r e z	k r e z d
d i k o d	d i k o d ɨ d
I k a n ɨ m Y z	I k a n ɨ m Y z d
I n m E S	I n m E S t
E k s o r s Y z	E k s o r s Y z d
h æ g ɨ l	h æ g ɨ l d
h o l	h o l d
I n s E n s	I n s E n s t
m a l I f Y	m a l I f Y d
n I g e t	n I g e t ɨ d
n I k	n I k t
W t l I v	W t l I v d
p E n s ɨ l	p E n s ɨ l d
p ɨ t I S ɨ n	p ɨ t I S ɨ n d
p l e t	p l e t ɨ d
p a p j U l R Y z	p a p j U l R Y z d
p a z I t	p a z I t ɨ d
k w e k	k w e k t
r I J u v ɨ n e t	r I J u v ɨ n e t ɨ d
r a k I t	r a k I t ɨ d
r ʌ p C R	r ʌ p C R d
s k æ v I n J	s k æ v I n J d
s p Y k	s p Y k t
s t i p	s t i p t
s t r æ g ɨ l	s t r æ g ɨ l d
s w I S	s w I S t
t r E s p æ s	t r E s p æ s t
ʌ n d R k ʌ t	ʌ n d R k ʌ t
w R d	w R d ɨ d
ɨ k ɔ s t	ɨ k ɔ s t ɨ d
æ k w i E s	æ k w i E s t
æ m p j U t e t	æ m p j U t e t ɨ d
b ɔ k	b ɔ k t
C Y d	C Y d ɨ d
k r æ N k	k r æ N k t
d E d ɨ n	d E d ɨ n d
d E n t	d E n t ɨ d
d r u l	d r u l d
E k s t r ɨ k e t	E k s t r ɨ k e t ɨ d
h æ l o	h æ l o d
Y d ɨ l	Y d ɨ l d
I m o b I l Y z	I m o b I l Y z d
J a S	J a S t
l æ C	l æ C t
m æ N g ɨ l	m æ N g ɨ l d
m Y m	m Y m d
m I s I n t R p r I t	m I s I n t R p r I t ɨ d
m I s l e	m I s l e d
o v R h ɔ l	o v R h ɔ l d
p R f j u m	p R f j u m d
p R p l E k s	p R p l E k s t
p r i n	p r i n d
r I s I p r ɨ k e t	r I s I p r ɨ k e t ɨ d
r i ɨ b I l I t e t	r i ɨ b I l I t e t ɨ d
r u s t	r u s t ɨ d
r o p	r o p t
S Y	S Y d
s l R	s l R d
s m ʌ J	s m ʌ J d
T i ɨ r Y z	T i ɨ r Y z d
ʌ p l I f t	ʌ p l I f t ɨ d
w Y t ɨ n	w Y t ɨ n d
z u m	z u m d
ɨ b E t	ɨ b E t ɨ d
ɨ J R n	ɨ J R n d
ɨ p r e z	ɨ p r e z d
b l æ N k I t	b l æ N k I t ɨ d
b l Y t	b l Y t ɨ d
d E k	d E k t
d i v æ l j u	d i v æ l j u d
d i v i e t	d i v i e t ɨ d
d I s I n g e J	d I s I n g e J d
d a n	d a n d
E s C u	E s C u d
g e m	g e m d
h E m	h E m d
W t d u	W t d I d
p æ s I f Y	p æ s I f Y d
p e r	p e r d
p e s t	p e s t ɨ d
p l a N k	p l a N k t
r æ m b ɨ l	r æ m b ɨ l d
r æ v ɨ l	r æ v ɨ l d
r i d i r E k t	r i d i r E k t ɨ d
r i f R b I S	r i f R b I S t
r E p r I m æ n d	r E p r I m æ n d ɨ d
r I t r e s	r I t r e s t
s i r	s i r d
s n I p	s n I p t
s k w ɔ k	s k w ɔ k t
T r a t ɨ l	T r a t ɨ l d
t r E k	t r E k t
w a d ɨ l	w a d ɨ l d
w E s t R n Y z	w E s t R n Y z d
ɨ t E s t	ɨ t E s t ɨ d
b I s i C	b I s ɔ t
k ɨ p I C U l e t	k ɨ p I C U l e t ɨ d
s R t I f Y	s R t I f Y d
k l I N k	k l I N k t
k l ʌ m p	k l ʌ m p t
k o ɨ l E s	k o ɨ l E s t
d I m i n	d I m i n d
d I s I l u Z ɨ n	d I s I l u Z ɨ n d
I n t w Y n	I n t w Y n d
E k s t r ɨ d Y t	E k s t r ɨ d Y t ɨ d
f æ s t	f æ s t ɨ d
f æ t	f æ t ɨ d
f E n d	f E n d ɨ d
g r ʌ b	g r ʌ b d
I n k ɨ p æ s I t e t	I n k ɨ p æ s I t e t ɨ d
I n s I n j u e t	I n s I n j u e t ɨ d
I n t ɨ m e t	I n t ɨ m e t ɨ d
I n v I g ɨ r e t	I n v I g ɨ r e t ɨ d
m ɨ n u r	m ɨ n u r d
m j u t	m j u t ɨ d
n u t R	n u t R d
p æ s C R Y z	p æ s C R Y z d
p r ɔ s t r e t	p r ɔ s t r e t ɨ d
r i d ʌ b ɨ l	r i d ʌ b ɨ l d
r i g r u p	r i g r u p t
r i T I N k	r i T ɔ t
S æ m b ɨ l	S æ m b ɨ l d
s l ʌ m b R	s l ʌ m b R d
s p l æ t R	s p l æ t R d
s p W t	s p W t ɨ d
s ɨ b s I s t	s ɨ b s I s t ɨ d
s w I l	s w I l d
t W z ɨ l	t W z ɨ l d
t u t R	t u t R d
v E k s	v E k s t
v I k t I m Y z	v I k t I m Y z d
ɨ n E k s	ɨ n E k s t
b a r J	b a r J d
b I k w i T	b I k w i T t
b r e v	b r e v d
b ʌ J I t	b ʌ J I t ɨ d
C æ m p i ɨ n	C æ m p i ɨ n d
C a r t	C a r t ɨ d
k l a b R	k l a b R d
k o r n	k o r n d
k j u b	k j u b d
d I k r Y	d I k r Y d
d I s o S i e t	d I s o S i e t ɨ d
I n k æ p s U l e t	I n k æ p s U l e t ɨ d
f W n d R	f W n d R d
h e r o	h e r o d
l I n C	l I n C t
m I s r E p r I z E n t	m I s r E p r I z E n t ɨ d
m a J u l e t	m a J u l e t ɨ d
n i d ɨ l	n i d ɨ l d
p l a p	p l a p t
p r E J U d I s	p r E J U d I s t
r æ d I k ɨ l Y z	r æ d I k ɨ l Y z d
s æ p	s æ p t
s I l u E t	s I l u E t ɨ d
s l e v	s l e v d
s t u p I f Y	s t u p I f Y d
s ʌ b d I v Y d	s ʌ b d I v Y d ɨ d
t r I p ɨ l	t r I p ɨ l d
t r o l	t r o l d
ʌ n d R p I n	ʌ n d R p I n d
æ g ɨ n Y z	æ g ɨ n Y z d
b r æ g	b r æ g d
b ʌ t r I s	b ʌ t r I s t
k o R s	k o R s t
k ɨ n J i l	k ɨ n J i l d
k ɨ r o d	k ɨ r o d ɨ d
k W n t ɨ n ɨ n s	k W n t ɨ n ɨ n s t
d I f o r m	d I f o r m d
d E s t I n	d E s t I n d
d I S	d I S t
d I s o r d R	d I s o r d R d
d I s o n	d I s o n d
d a k	d a k t
I m p e l	I m p e l d
I n ɔ g j U r e t	I n ɔ g j U r e t ɨ d
I n f j u z	I n f j u z d
l o p	l o p t
m æ s ɨ k R	m æ s ɨ k R d
m E T ɨ l e t	m E T ɨ l e t ɨ d
m I s J ʌ J	m I s J ʌ J d
m o r ɨ l Y z	m o r ɨ l Y z d
m o t ɨ r Y z	m o t ɨ r Y z d
n æ C R ɨ l Y z	n æ C R ɨ l Y z d
o v R ɔ	o v R ɔ d
p ʌ k R	p ʌ k R d
r I m æ n d	r I m æ n d ɨ d
r E m I n I s	r E m I n I s t
r i m a d ɨ l	r i m a d ɨ l d
r E n o v e t	r E n o v e t ɨ d
r i p e n t	r i p e n t ɨ d
r I p o z	r I p o z d
r I z W n d	r I z W n d ɨ d
r Y v	r Y v d
s l I N k	s l ʌ N k
s m a r t	s m a r t ɨ d
s p R t	s p R t ɨ d
s ʌ n b e D	s ʌ n b e D d
t u l	t u l d
t r æ n z m j u t	t r æ n z m j u t ɨ d
ʌ n d ɨ r e t	ʌ n d ɨ r e t ɨ d
ʌ n w Y n d	ʌ n w W n d
v æ N k w I S	v æ N k w I S t
w æ k	w æ k t
w i d ɨ l	w i d ɨ l d
b i r e t	b i r e t ɨ d
b I v w æ k	b I v w æ k t
k æ k ɨ l	k æ k ɨ l d
k æ s k e d	k æ s k e d ɨ d
s R k ɨ m s Y z	s R k ɨ m s Y z d
k W	k W d
d æ l i	d æ l i d
d i h j u m ɨ n Y z	d i h j u m ɨ n Y z d
d I m R	d I m R d
i v z d r a p	i v z d r a p t
f o r w ɨ d	f o r w ɨ d ɨ d
g æ b ɨ l	g æ b ɨ l d
g R d	g R d ɨ d
h ɨ r æ N	h ɨ r æ N d
h i l	h i l d
m ɨ r ɔ d	m ɨ r ɔ d ɨ d
n ʌ l I f Y	n ʌ l I f Y d
p a r t e k	p a r t U k
p E p R	p E p R d
p r i d I t R m I n	p r i d I t R m I n d
p r ɨ p W n d	p r ɨ p W n d ɨ d
r i k a n s t I t u t	r i k a n s t I t u t ɨ d
r E n d	r E n t
r i s t e t	r i s t e t ɨ d
s k ʌ f ɨ l	s k ʌ f ɨ l d
s n ʌ b	s n ʌ b d
s t æ g n e t	s t æ g n e t ɨ d
t i m	t i m d
v I n d I k e t	v I n d I k e t ɨ d
w æ g ɨ l	w æ g ɨ l d
b r i C	b r i C t
k e r I k ɨ C R	k e r I k ɨ C R d
d E l v	d E l v d
I m b E l I S	I m b E l I S t
I m b r O l	I m b r O l d
I p I t ɨ m Y z	I p I t ɨ m Y z d
I s t i m	I s t i m d
f E s t u n	f E s t u n d
f R o	f R o d
g l o t	g l o t ɨ d
g ʌ m	g ʌ m d
I n d I v I J u ɨ l Y z	I n d I v I J u ɨ l Y z d
I n t R s E k t	I n t R s E k t ɨ d
J E t I s ɨ n	J E t I s ɨ n d
l ɔ g	l ɔ g d
l a p	l a p t
m i æ n d R	m i æ n d R d
m E l o	m E l o d
m I s j u z	m I s j u z d
m ɨ l E s t	m ɨ l E s t ɨ d
ɨ k e Z ɨ n	ɨ k e Z ɨ n d
p i p ɨ l	p i p ɨ l d
p r Y m	p r Y m d
p ʌ N k C R	p ʌ N k C R d
k w a d r U p ɨ l	k w a d r U p ɨ l d
r i h W z	r i h W z d
r i I n s t e t	r i I n s t e t ɨ d
r I p r u v	r I p r u v d
r I t a r d	r I t a r d ɨ d
S Y n	S Y n d
s Y d	s Y d ɨ d
s p i r	s p i r d
t r æ n s f I k s	t r æ n s f I k s t
v e l	v e l d
w I N	w I N d
r æ N g ɨ l	r æ N g ɨ l d
æ k s E n t	æ k s E n t ɨ d
b æ k f Y R	b æ k f Y R d
b i d	b i d ɨ d
b E l t	b E l t ɨ d
b l I s t R	b l I s t R d
b l I t s	b l I t s t
k e n	k e n d
C æ n s	C æ n s t
k l O	k l O d
k o I g z I s t	k o I g z I s t ɨ d
k R t ɨ n	k R t ɨ n d
I n J O n	I n J O n d
f O l	f O l d
I n o v e t	I n o v e t ɨ d
I n ʌ n d e t	I n ʌ n d e t ɨ d
l e d ɨ l	l e d ɨ l d
l e R	l e R d
l I J I t I m Y z	l I J I t I m Y z d
l u b r I k e t	l u b r I k e t ɨ d
n o z	n o z d
o v R p W R	o v R p W R d
p e n	p e n d
p æ n d R	p æ n d R d
p ɔ	p ɔ d
p ɔ n	p ɔ n d
k w a n t I f Y	k w a n t I f Y d
r E v	r E v d
r I v o k	r I v o k t
r ʌ f	r ʌ f t
s k ɔ l d	s k ɔ l d ɨ d
s Y f ɨ n	s Y f ɨ n d
s k I t R	s k I t R d
s k ʌ l k	s k ʌ l k t
s k w a b ɨ l	s k w a b ɨ l d
s ɨ b s t æ n S i e t	s ɨ b s t æ n S i e t ɨ d
t o t	t o t ɨ d
w ɔ l s	w ɔ l s t
w R m	w R m d
b u	b u d
b ʌ f I t	b ʌ f I t ɨ d
s E n S R	s E n S R d
k l ʌ b	k l ʌ b d
k ɨ n v ʌ l s	k ɨ n v ʌ l s t
k o r s	k o r s t
k r I N k ɨ l	k r I N k ɨ l d
d I s p i r I t	d I s p i r I t ɨ d
f ɨ t i g	f ɨ t i g d
f l e m	f l e m d
f l e	f l e d
f o r w o r n	f o r w o r n d
f r I s k	f r I s k t
f r ɔ T	f r ɔ T t
g ʌ z ɨ l	g ʌ z ɨ l d
h E k ɨ l	h E k ɨ l d
Y t ɨ m Y z	Y t ɨ m Y z d
m ɨ l Y n	m ɨ l Y n d
m ɨ r u n	m ɨ r u n d
m a r t R	m a r t R d
m E n ɨ s	m E n ɨ s t
m E n s t r u e t	m E n s t r u e t ɨ d
m I s r i d	m I s r E d
m ʌ S r u m	m ʌ S r u m d
n I k n e m	n I k n e m d
o v R r u l	o v R r u l d
p i s	p i s t
p a t R	p a t R d
p r i E m p t	p r i E m p t ɨ d
k w o r i	k w o r i d
r I l E n t	r I l E n t ɨ d
r u Z	r u Z d
s i m	s i m d
s t I g m ɨ t Y z	s t I g m ɨ t Y z d
s t ʌ l t I f Y	s t ʌ l t I f Y d
s ɨ f j u z	s ɨ f j u z d
s w u n	s w u n d
t i	t i d
t r æ n s k r Y b	t r æ n s k r Y b d
t r ʌ m p I t	t r ʌ m p I t ɨ d
ʌ n d R p e	ʌ n d R p e d
v a r n I S	v a r n I S t
v E n t I l e t	v E n t I l e t ɨ d
w e v	w e v d
w U l f	w U l f t
æ J I t e t	æ J I t e t ɨ d
e r	e r d
b æ J R	b æ J R d
b a r t R	b a r t R d
b I d E v ɨ l	b I d E v ɨ l d
b I l i g R	b I l i g R d
b U l d o z	b U l d o z d
k ɨ v o r t	k ɨ v o r t ɨ d
C æ p	C æ p t
C e s ɨ n	C e s ɨ n d
s R k ɨ m s k r Y b	s R k ɨ m s k r Y b d
k l ʌ k	k l ʌ k t
k o s t	k o s t ɨ d
k ɨ l E k t I v Y z	k ɨ l E k t I v Y z d
k ɨ n s k r I p t	k ɨ n s k r I p t ɨ d
k a n t r ɨ v i n	k a n t r ɨ v i n d
d I l I n i e t	d I l I n i e t ɨ d
d i r Y d	d i r Y d ɨ d
d I s I n t æ N g ɨ l	d I s I n t æ N g ɨ l d
d I s h a r t ɨ n	d I s h a r t ɨ n d
d r ɔ l	d r ɔ l d
E d i	E d i d
I m e S i e t	I m e S i e t ɨ d
I m b ɔ s	I m b ɔ s t
I n f o l d	I n f o l d ɨ d
I n s k a n s	I n s k a n s t
f r i k	f r i k t
I n t R n ɨ l Y z	I n t R n ɨ l Y z d
l E v R	l E v R d
l a b	l a b d
m I s t r ʌ s t	m I s t r ʌ s t ɨ d
n æ v I g e t	n æ v I g e t ɨ d
o v R s t e t	o v R s t e t ɨ d
p e p R	p e p R d
p E d ɨ l	p E d ɨ l d
p j U r e	p j U r e d
k w e v R	k w e v R d
k w E n C	k w E n C t
k w E s t	k w E s t ɨ d
r i p r I n t	r i p r I n t ɨ d
r u f	r u f t
s k r W n J	s k r W n J d
s k ʌ d	s k ʌ d ɨ d
s i d	s i d ɨ d
S E p R d	S E p R d ɨ d
S U S	S U S t
s n Y p	s n Y p t
s p r E d i g ɨ l	s p r E d i g ɨ l d
ʌ n d R r Y t	ʌ n d R r o t
v W C s e f	v W C s e f t
C a m p	C a m p t
k a s I t	k a s I t ɨ d
k R t s i	k R t s i d
d I z I s t	d I z I s t ɨ d
d I s k l e m	d I s k l e m d
d I C	d I C t
d a k t R	d a k t R d
d u d ɨ l	d u d ɨ l d
d r E J	d r E J d
d u ɨ l	d u ɨ l d
I n u m ɨ r e t	I n u m ɨ r e t ɨ d
I k s t R n ɨ l Y z	I k s t R n ɨ l Y z d
f æ b r I k e t	f æ b r I k e t ɨ d
f l W t	f l W t ɨ d
f R D R	f R D R d
J R m ɨ n e t	J R m ɨ n e t ɨ d
g l ɔ s	g l ɔ s t
h ʌ m b ɨ l	h ʌ m b ɨ l d
I n v æ l I d e t	I n v æ l I d e t ɨ d
m æ n I k j U r	m æ n I k j U r d
m E S	m E S t
m ʌ l	m ʌ l d
o v R l e	o v R l e d
p Y n	p Y n d
p I v ɨ t	p I v ɨ t ɨ d
p l i t	p l i t ɨ d
r i b W n d	r i b W n d ɨ d
r I g r E s	r I g r E s t
r I l æ p s	r I l æ p s t
r Y f ɨ l	r Y f ɨ l d
r I v I t	r I v I t ɨ d
S r I l	S r I l d
s n I v ɨ l	s n I v ɨ l d
s a d	s a d ɨ d
s p e	s p e d
s t I l	s t I l d
s I N k r ɨ n Y z	s I N k r ɨ n Y z d
t ʌ f ɨ n	t ʌ f ɨ n d
t r æ n s f I g j R	t r æ n s f I g j R d
t r æ n s p o z	t r æ n s p o z d
t ʌ n ɨ l	t ʌ n ɨ l d
t w æ N	t w æ N d
ʌ n m æ s k	ʌ n m æ s k t
w i r i	w i r i d
w I g ɨ l	w I g ɨ l d
r i k	r i k t
æ b s E n t	æ b s E n t ɨ d
æ b s t r æ k t	æ b s t r æ k t ɨ d
ɨ k ʌ s t ɨ m	ɨ k ʌ s t ɨ m d
b æ n d i	b æ n d i d
b I g Y l	b I g Y l d
b I k R	b I k R d
b o t	b o t ɨ d
b o d	b o d ɨ d
b a C	b a C t
k æ n t	k æ n t ɨ d
k e p R	k e p R d
k l a k	k l a k t
k o a p t	k o a p t ɨ d
k a m ɨ n d i r	k a m ɨ n d i r d
k r o S e	k r o S e d
k r u s e d	k r u s e d ɨ d
d e n	d e n d
d i m o t	d i m o t ɨ d
d E s I k r e t	d E s I k r e t ɨ d
d I s l o k e t	d I s l o k e t ɨ d
d I s o r i ɨ n t	d I s o r i ɨ n t ɨ d
I n T r ɔ l	I n T r ɔ l d
I n v I Z ɨ n	I n v I Z ɨ n d
I g z a n ɨ r e t	I g z a n ɨ r e t ɨ d
f l ʌ d l Y t	f l ʌ d l Y t ɨ d
f o r S æ d o	f o r S æ d o d
h e r	h e r d
I n t R m I N g ɨ l	I n t R m I N g ɨ l d
W t f l æ N k	W t f l æ N k t
o v R r e t	o v R r e t ɨ d
p r i a k j U p Y	p r i a k j U p Y d
p r E S ɨ r Y z	p r E S ɨ r Y z d
p r I k ɨ l	p r I k ɨ l d
r E k ɨ n O t R	r E k ɨ n O t R d
r I k u p	r I k u p t
r I m	r I m d
s k i m	s k i m d
s k u l	s k u l d
s k u t	s k u t ɨ d
s k Y	s k Y d
s p l e	s p l e d
s k w E l C	s k w E l C t
s t æ S	s t æ S t
s ɨ b s u m	s ɨ b s u m d
t I l	t I l d
t a d ɨ l	t a d ɨ l d
t o n	t o n d
t o r p i d o	t o r p i d o d
ʌ n d R v æ l j u	ʌ n d R v æ l j u d
ʌ n f R l	ʌ n f R l d
ʌ n h U k	ʌ n h U k t
v E s t	v E s t ɨ d
w I n i	w I n i d
ɨ k l Y m ɨ t Y z	ɨ k l Y m ɨ t Y z d
e p	e p t
b l ʌ b R	b l ʌ b R d
k æ n t R	k æ n t R d
C ɔ k	C ɔ k t
k r a n I k ɨ l	k r a n I k ɨ l d
k l W n	k l W n d
d I k æ p I t e t	d I k æ p I t e t ɨ d
d E s I m e t	d E s I m e t ɨ d
I s t r e n J	I s t r e n J d
I g z ɔ l t	I g z ɔ l t ɨ d
g a r b ɨ l	g a r b ɨ l d
h æ z R d	h æ z R d ɨ d
h ʌ N g R	h ʌ N g R d
I m p R s ɨ n e t	I m p R s ɨ n e t ɨ d
I m p W n d	I m p W n d ɨ d
I n f r I n J	I n f r I n J d
m I s f Y R	m I s f Y R d
m o r t I f Y	m o r t I f Y d
ɔ s t r ɨ s Y z	ɔ s t r ɨ s Y z d
k w a S	k w a S t
r æ v I S	r æ v I S t
r i k I n d ɨ l	r i k I n d ɨ l d
r I p ʌ l s	r I p ʌ l s t
s l a g	s l a g d
s m E l t	s m E l t ɨ d
s o J R n	s o J R n d
s a d R	s a d R d
s p i r h E d	s p i r h E d ɨ d
s p r e n	s p r e n d
s t a k p Y l	s t a k p Y l d
s ʌ b l I m e t	s ʌ b l I m e t ɨ d
s ʌ p	s ʌ p t
ɨ t E n j u e t	ɨ t E n j u e t ɨ d
b I C	b I C t
b l Y n d f o l d	b l Y n d f o l d ɨ d
b a t ɨ l f i d	b a t ɨ l f E d
b r Y d ɨ l	b r Y d ɨ l d
b ʌ N g ɨ l	b ʌ N g ɨ l d
b R n I S	b R n I S t
b ʌ s	b ʌ s t
d I p o z	d I p o z d
d I s E n t	d I s E n t ɨ d
d I z i	d I z i d
I m b a m	I m b a m d
I k s t r u d	I k s t r u d ɨ d
f e r I t	f e r I t ɨ d
f Y n ɨ l Y z	f Y n ɨ l Y z d
f l E k	f l E k t
f r E S ɨ n	f r E S ɨ n d
g r a v ɨ l	g r a v ɨ l d
Y d ɨ l Y z	Y d ɨ l Y z d
I n t R p o z	I n t R p o z d
R k	R k t
J I g ɨ l	J I g ɨ l d
m ɔ l t	m ɔ l t ɨ d
m ʌ g	m ʌ g d
n æ p	n æ p t
W t r ʌ n	W t r æ n
p ɔ l	p ɔ l d
p æ l p I t e t	p æ l p I t e t ɨ d
p æ t ɨ n t	p æ t ɨ n t ɨ d
p i k	p i k t
p R k ɨ l e t	p R k ɨ l e t ɨ d
p r i d I s p o z	p r i d I s p o z d
p ʌ l v ɨ r Y z	p ʌ l v ɨ r Y z d
r I f r I J ɨ r e t	r I f r I J ɨ r e t ɨ d
r E z ɨ n e t	r E z ɨ n e t ɨ d
r I k ɨ S e	r I k ɨ S e d
r Y t	r Y t ɨ d
r a m p	r a m p t
s k r Y b	s k r Y b d
s k ʌ l p t	s k ʌ l p t ɨ d
S u	S u d
S o r	S o r d
s I l v R	s I l v R d
s p æ N g ɨ l	s p æ N g ɨ l d
s w æ g R	s w æ g R d
s w I g	s w I g d
t I t R	t I t R d
t r ʌ s	t r ʌ s t
ʌ p s t e J	ʌ p s t e J d
w E t	w E t ɨ d
r ɔ N	r ɔ N d
j E l p	j E l p t
ɨ n E s T ɨ t Y z	ɨ n E s T ɨ t Y z d
æ n t æ g ɨ n Y z	æ n t æ g ɨ n Y z d
b I g r ʌ J	b I g r ʌ J d
b u z	b u z d
b r a n z	b r a n z d
k o r ɨ s	k o r ɨ s t
k l O s t R	k l O s t R d
k a n s ɨ m e t	k a n s ɨ m e t ɨ d
d i k ɨ m p o z	d i k ɨ m p o z d
d I m p ɨ l	d I m p ɨ l d
d I s e b ɨ l	d I s e b ɨ l d
d I s g o r J	d I s g o r J d
d I s I n h e r I t	d I s I n h e r I t ɨ d
d r W z	d r W z d
I l u s I d e t	I l u s I d e t ɨ d
I m b o l d ɨ n	I m b o l d ɨ n d
f ɔ n	f ɔ n d
f I k s e t	f I k s e t ɨ d
h æ n d k ʌ f	h æ n d k ʌ f t
h a m a J ɨ n Y z	h a m a J ɨ n Y z d
I l t r i t	I l t r i t ɨ d
I m b Y b	I m b Y b d
I n t R s i d	I n t R s i d ɨ d
J I g	J I g d
l æ k R	l æ k R d
l a D R	l a D R d
m I s k ɨ n s i v	m I s k ɨ n s i v d
n a n p l ʌ s	n a n p l ʌ s t
ɨ f I S i e t	ɨ f I S i e t ɨ d
o r n ɨ m E n t	o r n ɨ m E n t ɨ d
o r f ɨ n	o r f ɨ n d
p e r i	p e r i d
p a r t I S ɨ n	p a r t I S ɨ n d
p I k n I k	p I k n I k t
p l e n	p l e n d
p r i ɨ r e n J	p r i ɨ r e n J d
p R l O n	p R l O n d
r æ s p	r æ s p t
r i l o d	r i l o d ɨ d
r I s I n d	r I s I n d ɨ d
r i s E t ɨ l	r i s E t ɨ l d
r i t e l	r i t e l d
r I f ɨ l	r I f ɨ l d
r ʌ t	r ʌ t ɨ d
s æ N k t I f Y	s æ N k t I f Y d
s k ʌ l p C R	s k ʌ l p C R d
S u	S u d
s Y d t r æ k	s Y d t r æ k t
s p a r	s p a r d
s t E n s ɨ l	s t E n s ɨ l d
s t r i m l Y n	s t r i m l Y n d
t a r	t a r d
t w i k	t w i k t
ʌ n d R s k o r	ʌ n d R s k o r d
R b ɨ n Y z	R b ɨ n Y z d
v æ k j u m	v æ k j u m d
w a l ɨ p	w a l ɨ p t
r i D	r i D d
ɨ b d ʌ k t	ɨ b d ʌ k t ɨ d
b I t o k ɨ n	b I t o k ɨ n d
k æ p t I n	k æ p t I n d
k ɨ k u n	k ɨ k u n d
k a d I f Y	k a d I f Y d
d æ m	d æ m d
d I g n I f Y	d I g n I f Y d
d I s I m b a r k	d I s I m b a r k t
d o p	d o p t
I n T u z	I n T u z d
I v I n s	I v I n s t
I k s k r i t	I k s k r i t ɨ d
f r a l I k	f r a l I k t
f ʌ n ɨ l	f ʌ n ɨ l d
g a g ɨ l	g a g ɨ l d
g o r	g o r d
g r e s	g r e s t
g ʌ f ɔ	g ʌ f ɔ d
h a r m ɨ n Y z	h a r m ɨ n Y z d
I n k ʌ l k e t	I n k ʌ l k e t ɨ d
m E t ɨ m o r f o z	m E t ɨ m o r f o z d
m I s d i r E k t	m I s d i r E k t ɨ d
W t	W t ɨ d
o v R r I k s p o z	o v R r I k s p o z d
o v R S u t	o v R S a t
p e l	p e l d
p a r t n R	p a r t n R d
p ɨ l I t I s Y z	p ɨ l I t I s Y z d
p ʌ l p	p ʌ l p t
r æ m p e J	r æ m p e J d
r I b ʌ f	r I b ʌ f t
r I k u p ɨ r e t	r I k u p ɨ r e t ɨ d
r e n	r e n d
r I p r i v	r I p r i v d
r I v Y l	r I v Y l d
r Y m	r Y m d
s æ v I J	s æ v I J d
S ʌ t ɨ l	S ʌ t ɨ l d
s Y d s t E p	s Y d s t E p t
s k I m p	s k I m p t
s l u	s l u d
s n e r	s n e r d
s o l J R	s o l J R d
s ʌ b J ɨ g e t	s ʌ b J ɨ g e t ɨ d
s ʌ n	s ʌ n d
t E l I g r æ f	t E l I g r æ f t
t E n ɨ n t	t E n ɨ n t ɨ d
t u t	t u t ɨ d
ʌ n d R s t e t	ʌ n d R s t e t ɨ d
ɨ m i l j ɨ r e t	ɨ m i l j ɨ r e t ɨ d
æ t r ɨ f i	æ t r ɨ f i d
ɔ d I S ɨ n	ɔ d I S ɨ n d
b ɨ l u n	b ɨ l u n d
b I h E d	b I h E d ɨ d
b l ʌ d	b l ʌ d ɨ d
b r U k	b r U k t
k æ p s Y z	k æ p s Y z d
k ɨ r i n	k ɨ r i n d
C R p	C R p t
C I z ɨ l	C I z ɨ l d
k a d ɨ l	k a d ɨ l d
k r I m p	k r I m p t
d æ p ɨ l	d æ p ɨ l d
d I f e s	d I f e s t
d E f ɨ k e t	d E f ɨ k e t ɨ d
d I s I m b W ɨ l	d I s I m b W ɨ l d
d ʌ b ɨ l k r ɔ s	d ʌ b ɨ l k r ɔ s t
I n k ʌ m b R	I n k ʌ m b R d
I n o b ɨ l	I n o b ɨ l d
I n ʌ n s i e t	I n ʌ n s i e t ɨ d
f ɨ m I l j ɨ r Y z	f ɨ m I l j ɨ r Y z d
f l ʌ f	f l ʌ f t
n æ S	n æ S t
g r u v	g r u v d
h ɨ l u s I n e t	h ɨ l u s I n e t ɨ d
h j u	h j u d
h I k ʌ p	h I k ʌ p t
I n d a k t r I n e t	I n d a k t r I n e t ɨ d
l æ n s	l æ n s t
l i e z	l i e z d
m æ n h æ n d ɨ l	m æ n h æ n d ɨ l d
m j u	m j u d
m u C	m u C t
m u t	m u t ɨ d
a b v i e t	a b v i e t ɨ d
W t l æ s t	W t l æ s t ɨ d
p e r ɨ d i	p e r ɨ d i d
p i l	p i l d
p I l I J	p I l I J d
p r i I g z I s t	p r i I g z I s t ɨ d
k w I b ɨ l	k w I b ɨ l d
k w Y ɨ t	k w Y ɨ t ɨ d
r æ N k ɨ l	r æ N k ɨ l d
r i ɨ J ʌ s t	r i ɨ J ʌ s t ɨ d
r i C a r J	r i C a r J d
r i I m b R s	r i I m b R s t
r I J	r I J d
r o m æ n t I s Y z	r o m æ n t I s Y z d
s k W t	s k W t ɨ d
S R k	S R k t
s I v	s I v d
s I n J	s I n J d
s l a b R	s l a b R d
s o p	s o p t
s p ʌ t R	s p ʌ t R d
s t æ m p i d	s t æ m p i d ɨ d
t æ l i	t æ l i d
t I t I l e t	t I t I l e t ɨ d
t r æ f I k	t r æ f I k t
t r æ n s g r E s	t r æ n s g r E s t
ɨ r e	ɨ r e d
b e r I k e d	b e r I k e d ɨ d
b r æ k I t	b r æ k I t ɨ d
b r e	b r e d
b ʌ d	b ʌ d ɨ d
b R g ɨ l	b R g ɨ l d
s R k ɨ m v E n t	s R k ɨ m v E n t ɨ d
k ɨ l e t	k ɨ l e t ɨ d
k a p	k a p t
k o r d	k o r d ɨ d
d I k l e m	d I k l e m d
d I n u d	d I n u d ɨ d
d Y g r E s	d Y g r E s t
d I s d e n	d I s d e n d
d I s E m b ɨ l	d I s E m b ɨ l d
d a f	d a f t
d W n g r e d	d W n g r e d ɨ d
I l o p	I l o p t
I k s p a s C U l e t	I k s p a s C U l e t ɨ d
E k s p r o p r i e t	E k s p r o p r i e t ɨ d
I k s t r æ p ɨ l e t	I k s t r æ p ɨ l e t ɨ d
I g z ʌ l t	I g z ʌ l t ɨ d
f a D R	f a D R d
f I z	f I z d
f l ʌ N k	f l ʌ N k t
f ʌ J	f ʌ J d
f R	f R d
g a r n R	g a r n R d
h E d l Y n	h E d l Y n d
h Y b R n e t	h Y b R n e t ɨ d
h Y J æ k	h Y J æ k t
I m p e r ɨ l	I m p e r ɨ l d
I n a k j U l e t	I n a k j U l e t ɨ d
I n t R w i v	I n t R w o v
l æ s ɨ r e t	l æ s ɨ r e t ɨ d
m ʌ d i	m ʌ d i d
o v R C a r J	o v R C a r J d
p Y l ɨ t	p Y l ɨ t ɨ d
p a s C R	p a s C R d
p r E f I s	p r E f I s t
p r E s I J	p r E s I J d
r u m	r u m d
S i D	S i D d
s w a t	s w a t ɨ d
t w Y n	t w Y n d
v E n d	v E n d ɨ d
w I n o	w I n o d
z æ p	z æ p t
z I g z æ g	z I g z æ g d
ɨ s E n t	ɨ s E n t ɨ d
ɨ t Y R	ɨ t Y R d
ɔ d I t	ɔ d I t ɨ d
ɔ T E n t I k e t	ɔ T E n t I k e t ɨ d
b i C	b i C t
b Y s E k t	b Y s E k t ɨ d
b l ʌ s t R	b l ʌ s t R d
b a g ɨ l	b a g ɨ l d
b a k s	b a k s t
b ʌ m	b ʌ m d
k æ p t I v e t	k æ p t I v e t ɨ d
k ɨ r i r	k ɨ r i r d
k æ s t I g e t	k æ s t I g e t ɨ d
s i d	s i d ɨ d
C i p ɨ n	C i p ɨ n d
k l o k	k l o k t
k l a z I t	k l a z I t ɨ d
k o l	k o l d
k o r s ɨ n	k o r s ɨ n d
k W n t R v e l	k W n t R v e l d
d I k æ n t	d I k æ n t ɨ d
d i f r ɔ s t	d i f r ɔ s t ɨ d
d I m a k r ɨ t Y z	d I m a k r ɨ t Y z d
d E p r I k e t	d E p r I k e t ɨ d
d E s I k e t	d E s I k e t ɨ d
d Y s	d Y s t
d I s I n C æ n t	d I s I n C æ n t ɨ d
d o s	d o s t
d ʌ m f W n d	d ʌ m f W n d ɨ d
E n k o d	E n k o d ɨ d
E s e	E s e d
E k s Y z	E k s Y z d
f a r t	f a r t ɨ d
f E t R	f E t R d
f o r s f i d	f o r s f E d
g r æ v ɨ l	g r æ v ɨ l d
h a g	h a g d
h U d w I N k	h U d w I N k t
I m o r t ɨ l Y z	I m o r t ɨ l Y z d
I n k a r s R e t	I n k a r s R e t ɨ d
I n g r e S i e t	I n g r e S i e t ɨ d
J æ b R	J æ b R d
k i	k i d
n Y t	n Y t ɨ d
l ɔ d	l ɔ d ɨ d
ɔ s I f Y	ɔ s I f Y d
o v R p e	o v R p e d
o v R s t E p	o v R s t E p t
p l ʌ m	p l ʌ m d
p o l	p o l d
p r a m ɨ l g e t	p r a m ɨ l g e t ɨ d
p r a s p E k t	p r a s p E k t ɨ d
r e d i o	r e d i o d
r i f o r m	r i f o r m d
r E J I m E n t	r E J I m E n t ɨ d
r o b	r o b d
r ʌ f ɨ n	r ʌ f ɨ n d
s æ t R Y z	s æ t R Y z d
s E n t I m E n t ɨ l Y z	s E n t I m E n t ɨ l Y z d
s l R p	s l R p t
s n I k R	s n I k R d
s p u k	s p u k t
s t ʌ m ɨ k	s t ʌ m ɨ k t
s t r æ t I f Y	s t r æ t I f Y d
s ʌ b	s ʌ b d
t r æ n z æ k t	t r æ n z æ k t ɨ d
ʌ n b æ l ɨ n s	ʌ n b æ l ɨ n s t
v e k e S ɨ n	v e k e S ɨ n d
ɨ b æ S	ɨ b æ S t
ɨ b r I J	ɨ b r I J d
ɨ J ʌ J	ɨ J ʌ J d
e r e t	e r e t ɨ d
æ n o t e t	æ n o t e t ɨ d
ɨ p r E n t I s	ɨ p r E n t I s t
ɨ t o n	ɨ t o n d
b æ N k r ʌ p t	b æ N k r ʌ p t ɨ d
b I l e	b I l e d
b I m o n	b I m o n d
b r O l	b r O l d
b R b ɨ l	b R b ɨ l d
C æ s t Y z	C æ s t Y z d
k l Y m æ k s	k l Y m æ k s t
k l W t	k l W t ɨ d
k ɨ m R S ɨ l Y z	k ɨ m R S ɨ l Y z d
k ɨ n Y v	k ɨ n Y v d
k r i m e t	k r i m e t ɨ d
d I f ɔ l t	d I f ɔ l t ɨ d
d R t i	d R t i d
d I s b R s	d I s b R s t
d I s a n R	d I s a n R d
d I s I n f E k t	d I s I n f E k t ɨ d
d I s p o r t	d I s p o r t ɨ d
d I s t ɨ n s	d I s t ɨ n s t
E g z I t	E g z I t ɨ d
f l æ b R g æ s t	f l æ b R g æ s t ɨ d
f l o r	f l o r d
f l W n s	f l W n s t
f o r d	f o r d ɨ d
f R l	f R l d
g r æ n j U l e t	g r æ n j U l e t ɨ d
g r ʌ J	g r ʌ J d
h æ m s t r I N	h æ m s t r ʌ N
h a r t ɨ n	h a r t ɨ n d
h I C h Y k	h I C h Y k t
h Y v	h Y v d
h o n	h o n d
I n d E k s	I n d E k s t
I n t u I t	I n t u I t ɨ d
J a k i	J a k i d
m I m i ɨ g r æ f	m I m i ɨ g r æ f t
m I s b I h e v	m I s b I h e v d
m I s t	m I s t ɨ d
m a t ɨ l	m a t ɨ l d
n a C	n a C t
a b l I g e t	a b l I g e t ɨ d
p R f ɨ r e t	p R f ɨ r e t ɨ d
p I N	p I N d
p l ʌ m I t	p l ʌ m I t ɨ d
p a t	p a t ɨ d
p r ɨ p o r S ɨ n	p r ɨ p o r S ɨ n d
p r ɔ s ɨ l I t Y z	p r ɔ s ɨ l I t Y z d
k w I p	k w I p t
r i l o k e t	r i l o k e t ɨ d
r i j u z	r i j u z d
r i v æ l j u	r i v æ l j u d
r u m I n e t	r u m I n e t ɨ d
s e t	s e t ɨ d
s Y D	s Y D d
s E k ɨ n d	s E k ɨ n d ɨ d
s E n s I t Y z	s E n s I t Y z d
S I p r E k	S I p r E k t
s l I m	s l I m d
s n æ g	s n æ g d
s n o b ɔ l	s n o b ɔ l d
s a r o	s a r o d
s p i r I t	s p i r I t ɨ d
s t r e f	s t r e f t
s t r ʌ m	s t r ʌ m d
s ʌ l i	s ʌ l i d
s w I n d ɨ l	s w I n d ɨ l d
t E n d R	t E n d R d
t r W n s	t r W n s t
t r ʌ N k e t	t r ʌ N k e t ɨ d
j u n j ɨ n Y z	j u n j ɨ n Y z d
ʌ n t æ N g ɨ l	ʌ n t æ N g ɨ l d
v R b ɨ l Y z	v R b ɨ l Y z d
w æ N g ɨ l	w æ N g ɨ l d
w I n t R	w I n t R d
j æ p	j æ p t
æ d ɨ l	æ d ɨ l d
ɨ p E n d	ɨ p E n d ɨ d
ɨ p r Y z	ɨ p r Y z d
b I f ʌ d ɨ l	b I f ʌ d ɨ l d
b E l	b E l d
b l a k e d	b l a k e d ɨ d
b l ʌ J ɨ n	b l ʌ J ɨ n d
b r u t ɨ l Y z	b r u t ɨ l Y z d
C i k	C i k t
k l æ k	k l æ k t
k r e t	k r e t ɨ d
k r U k	k r U k t
d ɔ b	d ɔ b d
d I p r i S i e t	d I p r i S i e t ɨ d
d I s ɨ s o s i e t	d I s ɨ s o s i e t ɨ d
d I s p ɨ z E s	d I s p ɨ z E s t
d ʌ N k	d ʌ N k t
d Y n ɨ m Y t	d Y n ɨ m Y t ɨ d
E l b o	E l b o d
I l E k t r ɨ k j u t	I l E k t r ɨ k j u t ɨ d
I n t r E n C	I n t r E n C t
E g z u m	E g z u m d
f e n t	f e n t ɨ d
f I l C	f I l C t
f I N g R p r I n t	f I N g R p r I n t ɨ d
f o r b e r	f o r b o r
g ɔ l	g ɔ l d
g æ S	g æ S t
g o s t	g o s t ɨ d
g ʌ t R	g ʌ t R d
h o s t	h o s t ɨ d
h ʌ f	h ʌ f t
h ʌ z b ɨ n d	h ʌ z b ɨ n d ɨ d
I n s I n ɨ r e t	I n s I n ɨ r e t ɨ d
I n J E s t	I n J E s t ɨ d
m e r I n e t	m e r I n e t ɨ d
m æ s t R m Y n d	m æ s t R m Y n d ɨ d
m o l d R	m o l d R d
m o l t	m o l t ɨ d
o p Y n	o p Y n d
p R J R	p R J R d
p r o s k r Y b	p r o s k r Y b d
r e z	r e z d
r I k æ n t	r I k æ n t ɨ d
r i d E k ɨ r e t	r i d E k ɨ r e t ɨ d
r I m I t	r I m I t ɨ d
r i p e t r i e t	r i p e t r i e t ɨ d
r ʌ b R s t æ m p	r ʌ b R s t æ m p t
s e S i e t	s e S i e t ɨ d
s k r ʌ n C	s k r ʌ n C t
s I s i d	s I s i d ɨ d
s n u z	s n u z d
s n ʌ f ɨ l	s n ʌ f ɨ l d
s t ɔ n C	s t ɔ n C t
s t o n w ɔ l	s t o n w ɔ l d
s ɨ p i n ɨ	s ɨ p i n ɨ d
S U g R	S U g R d
s w a d ɨ l	s w a d ɨ l d
s I s t I m ɨ t Y z	s I s t I m ɨ t Y z d
t E l E k s	t E l E k s t
t r I l	t r I l d
ʌ n b Y n d	ʌ n b W n d
ʌ n l R n	ʌ n l R n d
v e p ɨ r Y z	v e p ɨ r Y z d
v E n ɨ r e t	v E n ɨ r e t ɨ d
w E d	w E d ɨ d
ɨ J u d I k e t	ɨ J u d I k e t ɨ d
ɨ p o r S ɨ n	ɨ p o r S ɨ n d
e r ɨ g e t	e r ɨ g e t ɨ d
b æ k t r æ k	b æ k t r æ k t
b Y d	b Y d ɨ d
k æ v	k æ v d
k a r p	k a r p t
k ɔ	k ɔ d
C æ f	C æ f t
k ɨ m j u n	k ɨ m j u n d
k a m p a r t m E n t ɨ l Y z	k a m p a r t m E n t ɨ l Y z d
k W n t ɨ r ɨ t æ k	k W n t ɨ r ɨ t æ k t
k r ɔ s I g z æ m I n	k r ɔ s I g z æ m I n d
d E s ɨ l e t	d E s ɨ l e t ɨ d
I f e s	I f e s t
I n f i b ɨ l	I n f i b ɨ l d
f o r k l o z	f o r k l o z d
h o z	h o z d
J O n t	J O n t ɨ d
l I b R ɨ l Y z	l I b R ɨ l Y z d
m ɨ S i n	m ɨ S i n d
m æ l t r i t	m æ l t r i t ɨ d
m I s k e r i	m I s k e r i d
m u	m u d
m j u t e t	m j u t e t ɨ d
n e r e t	n e r e t ɨ d
n I g ɨ l	n I g ɨ l d
ɨ b t r u d	ɨ b t r u d ɨ d
p e r ɨ f r e z	p e r ɨ f r e z d
p r a p ɨ z I S ɨ n	p r a p ɨ z I S ɨ n d
p r ɔ s t I t u t	p r ɔ s t I t u t ɨ d
k w I z	k w I z d
r i a r m	r i a r m d
r i f I t	r i f I t ɨ d
r i f l e t	r i f l e t ɨ d
r i s R f I s	r i s R f I s t
r i t E l	r i t o l d
r i v æ m p	r i v æ m p t
r i v I v I f Y	r i v I v I f Y d
s k a C	s k a C t
s k R J	s k R J d
s k R m I S	s k R m I S t
s n u p	s n u p t
s a k	s a k t
s t r æ n d	s t r æ n d ɨ d
s w Y p	s w Y p t
t r e p s	t r e p s t
t r æ N k w I l Y z	t r æ N k w I l Y z d
v æ n d ɨ l Y z	v æ n d ɨ l Y z d
æ b r ɨ g e t	æ b r ɨ g e t ɨ d
ɨ J u r	ɨ J u r d
æ g r I g e t	æ g r I g e t ɨ d
æ N g l I s Y z	æ N g l I s Y z d
ɨ n ʌ l	ɨ n ʌ l d
ɨ v W	ɨ v W d
b l o t	b l o t ɨ d
b a p	b a p t
b O	b O d
b R p	b R p t
S æ p ɨ r o n	S æ p ɨ r o n d
k r æ f t	k r æ f t ɨ d
k r æ p	k r æ p t
d i k a l ɨ n Y z	d i k a l ɨ n Y z d
d I s ɨ l W	d I s ɨ l W d
d I s o r i ɨ n t e t	d I s o r i ɨ n t e t ɨ d
d r æ t	d r æ t ɨ d
E d I f Y	E d I f Y d
E n R v e t	E n R v e t ɨ d
I n t r i t	I n t r i t ɨ d
I k w I v ɨ k e t	I k w I v ɨ k e t ɨ d
f R m	f R m d
f o r S o r t ɨ n	f o r S o r t ɨ n d
J E n j u f l E k t	J E n j u f l E k t ɨ d
g u f	g u f t
g r Y p	g r Y p t
J Y r e t	J Y r e t ɨ d
h o m	h o m d
I m j U n Y z	I m j U n Y z d
I m p æ k t	I m p æ k t ɨ d
I n t R n æ S ɨ n ɨ l Y z	I n t R n æ S ɨ n ɨ l Y z d
J a g ɨ l	J a g ɨ l d
k e o	k e o d
l æ m p u n	l æ m p u n d
l Y m	l Y m d
m æ l f ʌ N k S ɨ n	m æ l f ʌ N k S ɨ n d
m I n t	m I n t ɨ d
m ʌ s	m ʌ s t
m ʌ z ɨ l	m ʌ z ɨ l d
o v R m æ n	o v R m æ n d
p R k	p R k t
p ɨ r u z	p ɨ r u z d
f o t o k a p i	f o t o k a p i d
p l e æ k t	p l e æ k t ɨ d
p ʌ m ɨ l	p ʌ m ɨ l d
p o r t E n d	p o r t E n d ɨ d
r e l	r e l d
r E d i	r E d i d
r i d u	r i d I d
r E p l I k e t	r E p l I k e t ɨ d
r i s t a k	r i s t a k t
r i t ʌ C	r i t ʌ C t
r I v E n J	r I v E n J d
r Y l	r Y l d
s æ n d	s æ n d ɨ d
s æ n d b æ g	s æ n d b æ g d
s k æ b	s k æ b d
s Y n p o s t	s Y n p o s t ɨ d
s k j u R	s k j u R d
s l e k	s l e k t
s l æ n d R	s l æ n d R d
s l ʌ g	s l ʌ g d
s ʌ p j R e t	s ʌ p j R e t ɨ d
s I n d I k e t	s I n d I k e t ɨ d
t e b ɨ l	t e b ɨ l d
t æ m p	t æ m p t
t W t	t W t ɨ d
ʌ n b ʌ k ɨ l	ʌ n b ʌ k ɨ l d
ʌ n b R d ɨ n	ʌ n b R d ɨ n d
ʌ n k ʌ p ɨ l	ʌ n k ʌ p ɨ l d
ʌ n d R s t ʌ d i	ʌ n d R s t ʌ d i d
ʌ n h I n J	ʌ n h I n J d
ʌ p E n d	ʌ p E n d ɨ d
v I l I f Y	v I l I f Y d
w o r b ɨ l	w o r b ɨ l d
E k s r e	E k s r e d
z i r a k s	z i r a k s t
ɨ k r E d I t	ɨ k r E d I t ɨ d
ɔ t ɨ g r æ f	ɔ t ɨ g r æ f t
ɨ v R	ɨ v R d
b æ k s l Y d	b æ k s l I d
b e ɨ n E t	b e ɨ n E t ɨ d
b I s t r Y d	b I s t r o d
b I l I t	b I l I t ɨ d
b ʌ N	b ʌ N d
k æ J	k æ J d
k æ n ɨ n Y z	k æ n ɨ n Y z d
k ɨ p e r I s ɨ n	k ɨ p e r I s ɨ n d
k e s	k e s t
C e n s m o k	C e n s m o k t
s Y f R	s Y f R d
k l R r k	k l R r k t
k o æ g j U l e t	k o æ g j U l e t ɨ d
k ɨ l u d	k ɨ l u d ɨ d
k ɨ n o t	k ɨ n o t ɨ d
k a n v ɨ l E s	k a n v ɨ l E s t
k W n t R b æ l ɨ n s	k W n t R b æ l ɨ n s t
k W n t R f I t	k W n t R f I t ɨ d
k R i	k R i d
d I b ɔ C	d I b ɔ C t
d I f e m	d I f e m d
d I s p O l	d I s p O l d
d I s k ʌ m f I t	d I s k ʌ m f I t ɨ d
E n R J Y z	E n R J Y z d
I n t r æ p	I n t r æ p t
E k s k ɨ m j u n I k e t	E k s k ɨ m j u n I k e t ɨ d
f e r o	f e r o d
f I z ɨ l	f I z ɨ l d
f r i w i l	f r i w i l d
g æ m b ɨ l	g æ m b ɨ l d
h a l ɨ d e	h a l ɨ d e d
h U d	h U d ɨ d
I n s Y z	I n s Y z d
I n t R l e s	I n t R l e s t
J I b	J I b d
J I l t	J I l t ɨ d
l æ m	l æ m d
l E v ɨ n	l E v ɨ n d
l I s p	l I s p t
m æ t	m æ t ɨ d
m Y k r o f I l m	m Y k r o f I l m d
m Y R	m Y R d
m a b	m a b d
m ʌ f	m ʌ f t
n R v	n R v d
W t s E l	W t s o l d
W t S Y n	W t S o n
o v R r i t	o v R r e t
o v R d r E s	o v R d r E s t
o v R p l e	o v R p l e d
o v R s l i p	o v R s l E p t
a k s I J ɨ n e t	a k s I J ɨ n e t ɨ d
p ʌ d ɨ l	p ʌ d ɨ l d
r i k ɨ p I C u l e t	r i k ɨ p I C u l e t ɨ d
r I f r æ k t	r I f r æ k t ɨ d
r I g R J I t e t	r I g R J I t e t ɨ d
r i m W n t	r i m W n t ɨ d
r u t	r u t ɨ d
s k a l ɨ p	s k a l ɨ p t
s k æ l p	s k æ l p t
s e r ɨ n e d	s e r ɨ n e d ɨ d
S o r t s R k I t	S o r t s R k I t ɨ d
S r I m p	S r I m p t
s I C u e t	s I C u e t ɨ d
s l e t	s l e t ɨ d
s l Y t	s l Y t ɨ d
s n I f ɨ l	s n I f ɨ l d
s t e b ɨ l	s t e b ɨ l d
t E l I s k o p	t E l I s k o p t
ʌ n s i t	ʌ n s i t ɨ d
v æ s ɨ l e t	v æ s ɨ l e t ɨ d
w e J R	w e J R d
w e l e	w e l e d
ɨ d u s	ɨ d u s t
ɨ d ʌ l t ɨ r e t	ɨ d ʌ l t ɨ r e t ɨ d
ɨ d v æ n t I J	ɨ d v æ n t I J d
ɨ f I k s	ɨ f I k s t
æ m o r t Y z	æ m o r t Y z d
æ n t I d e t	æ n t I d e t ɨ d
ɨ r e n	ɨ r e n d
a r t I k ɨ l	a r t I k ɨ l d
æ s f æ l t	æ s f æ l t ɨ d
b æ l ɨ t	b æ l ɨ t ɨ d
b I s p i k	b I s p o k
b I t e k	b I t U k
k ɨ r W z	k ɨ r W z d
S ɨ g r I n	S ɨ g r I n d
k a m p o s t	k a m p o s t ɨ d
k r I s k r ɔ s	k r I s k r ɔ s t
k ʌ s	k ʌ s t
d æ n d ɨ l	d æ n d ɨ l d
d I b a r k	d I b a r k t
d E b I t	d E b I t ɨ d
d I k æ m p	d I k æ m p t
d i s E l ɨ r e t	d i s E l ɨ r e t ɨ d
d I f r ɔ d	d I f r ɔ d ɨ d
d i h Y d r e t	d i h Y d r e t ɨ d
d i p a p j U l e t	d i p a p j U l e t ɨ d
d i r e l	d i r e l d
d I s I n k l Y n	d I s I n k l Y n d
d I s I n t R	d I s I n t R d
d ʌ b ɨ l C E k	d ʌ b ɨ l C E k t
d u p	d u p t
I m b l e z ɨ n	I m b l e z ɨ n d
I n k æ m p	I n k æ m p t
I n r æ p C R	I n r æ p C R d
I n s n e r	I n s n e r d
j u l ɨ J Y z	j u l ɨ J Y z d
I k s p ʌ n J	I k s p ʌ n J d
f ʌ l m I n e t	f ʌ l m I n e t ɨ d
g a r l ɨ n d	g a r l ɨ n d ɨ d
g R d ɨ l	g R d ɨ l d
g l æ d ɨ n	g l æ d ɨ n d
g l ʌ t	g l ʌ t ɨ d
g r I t	g r I t ɨ d
h e z	h e z d
I m p i C	I m p i C t
I m p j u n	I m p j u n d
I n k ɨ n v i n j ɨ n s	I n k ɨ n v i n j ɨ n s t
I n I S ɨ l	I n I S ɨ l d
I n l e	I n l e d
I n s E t	I n s E t
J E t	J E t ɨ d
J ʌ k s t ɨ p o z	J ʌ k s t ɨ p o z d
k i n	k i n d
l æ m I n e t	l æ m I n e t ɨ d
l e z	l e z d
l E g	l E g d
l I l t	l I l t ɨ d
l I m b R	l I m b R d
m æ n ɨ k ɨ l	m æ n ɨ k ɨ l d
m R C ɨ n d Y z	m R C ɨ n d Y z d
m o r t R	m o r t R d
m ʌ m I f Y	m ʌ m I f Y d
n æ b	n æ b d
n E t ɨ l	n E t ɨ l d
o r e t	o r e t ɨ d
W t d I s t ɨ n s	W t d I s t ɨ n s t
W t m ɨ n u v R	W t m ɨ n u v R d
o v R r I n d ʌ l J	o v R r I n d ʌ l J d
o v R b æ l ɨ n s	o v R b æ l ɨ n s t
o v R r b R d ɨ n	o v R r b R d ɨ n d
o v R d r ɔ	o v R d r u
o v R t æ k s	o v R t æ k s t
p ɨ r o l	p ɨ r o l d
p a r t I k j U l R Y z	p a r t I k j U l R Y z d
p i k	p i k t
p l e t	p l e t ɨ d
p r i d E s t I n	p r i d E s t I n d
p r E d I k e t	p r E d I k e t ɨ d
p r I v e r I k e t	p r I v e r I k e t ɨ d
p r a p ɨ g æ n d Y z	p r a p ɨ g æ n d Y z d
p j u k	p j u k t
r i æ k t I v e t	r i æ k t I v e t ɨ d
r i k æ s t	r i k æ s t ɨ d
r I s E s	r I s E s t
r i d I p l O	r i d I p l O d
r a n d I v u	r a n d I v u d
r E k w I z I S ɨ n	r E k w I z I S ɨ n d
r i s E t	r i s E t
r I s ʌ s I t e t	r I s ʌ s I t e t ɨ d
r i t u l	r i t u l d
r ʌ s t I k e t	r ʌ s t I k e t ɨ d
s æ l v	s æ l v d
S o r t l I s t	S o r t l I s t ɨ d
s p l Y s	s p l Y s t
s p l R J	s p l R J d
s w a b	s w a b d
s w a t	s w a t ɨ d
t o	t o d
t r ɔ l	t r ɔ l d
ʌ n d R p l e	ʌ n d R p l e d
ʌ p b r e d	ʌ p b r e d ɨ d
v ɔ n t	v ɔ n t ɨ d
v E J I t e t	v E J I t e t ɨ d
v a l i	v a l i d
w I n C	w I n C t