a k j ə p aɪ̯	a k j ə p aɪ̯ d
a n ɚ	a n ɚ d
a r ɡ j u	a r ɡ j u d
a r m	a r m d
a r t ɪ k ə l	a r t ɪ k ə l d
æ d ə l	æ d ə l d
æ d h i r	æ d h i r d
æ d v ɚ t aɪ̯ z	æ d v ɚ t aɪ̯ z d
æ ɡ ə n aɪ̯ z	æ ɡ ə n aɪ̯ z d
æ m b ə l	æ m b ə l d

a b l ɪ ɡ eɪ̯ t	a b l ɪ ɡ eɪ̯ t ə d
a b v i eɪ̯ t	a b v i eɪ̯ t ə d
a k s ɪ ʤ ə n eɪ̯ t	a k s ɪ ʤ ə n eɪ̯ t ə d
a p ə r eɪ̯ t	a p ə r eɪ̯ t ə d
a r t ɪ k j ʊ l eɪ̯ t	a r t ɪ k j ʊ l eɪ̯ t ə d
a s ɪ l eɪ̯ t	a s ɪ l eɪ̯ t ə d
æ b d ɪ k eɪ̯ t	æ b d ɪ k eɪ̯ t ə d
æ b r ə ɡ eɪ̯ t	æ b r ə ɡ eɪ̯ t ə d
æ b s ɛ n t	æ b s ɛ n t ə d
æ b s t r æ k t	æ b s t r æ k t ə d

a r ʧ	a r ʧ t
æ d m a n ɪ ʃ	æ d m a n ɪ ʃ t
æ k w i ɛ s	æ k w i ɛ s t
æ m b ʊ ʃ	æ m b ʊ ʃ t
æ s k	æ s k t
aʊ̯ t f l æ ŋ k	aʊ̯ t f l æ ŋ k t
aʊ̯ t s t r ɪ p	aʊ̯ t s t r ɪ p t
b a k s	b a k s t
b a p	b a p t
b a r k	b a r k t

b r eɪ̯ k	b r oʊ̯ k
d aɪ̯ v	d oʊ̯ v
d r aɪ̯ v	d r oʊ̯ v
ə r aɪ̯ z	ə r oʊ̯ z
ə w eɪ̯ k	ə w oʊ̯ k
f r i z	f r oʊ̯ z
r aɪ̯ d	r oʊ̯ d
r aɪ̯ t	r oʊ̯ t
r aɪ̯ z	r oʊ̯ z
s p i k	s p oʊ̯ k
