s o r A g	s o r a g I m
l E k e t	l e k a t I m
g A g	g a g O t
r a v I d	r e v i d I m
k o n g r E s	k o n g r E s i m
k u v l a n A	k u v l a n O t
n a v A l	n e v a l I m
n E sh e k	n e sh a k I m
h i t k o m e m U t	h i t k o m e m u j O t
ts i j U n	ts i j u n I m
m i t a b E d	m i t a b d I m
r i s U s	r i s u s I m
n e t i A	n e t i O t
p I l p e l	p I l p e l i m
x a l a v i j U t	x a l a v i j u j O t
n i d U j	n i d u j I m
t f i r A	t f i r O t
m a g a sh I t	m a g a sh i j O t
x a r z A n	x a r z a n I m
z i h U j	z i h u j I m
m i t l E	m i t l I m
k a r d j o g r A m a	k a r d j o g r A m o t
m e l i x U t	m e l i x u j O t
b u x n A	b u x n O t
r E j sh	r e j sh I m
i n f E k ts j a	i n f E k ts j o t
m i s g U r	m i s g u r I m
p I n	p i n I m
h I d r a	h I d r o t
ts m i d U t	ts m i d u j O t
z o h a m A	z o h a m O t
p s i O n e t	p s i o n O t
t a x p O s e t	t a x p o s O t
I r	a r I m
t i p U a x	t i p u x I m
t a g A r	t a g a r I m
d x i f A	d x i f O t
k i t U f	k i t u f I m
a l A l	a l a l I m
p A a m	p e a m I m
n e v i x A	n e v i x O t
m A x a t	m e x a t I m
f l O r a	f l O r o t
h a l a m A	h a l a m O t
sh a x ts A n	sh a x ts a n I m
k a sh k E sh e t	k a sh k a sh O t
i x p A t i j u t	i x p A t i j u j o t
p u n d A k	p u n d a k I m
t i r t U r	t i r t u r I m
p U r	p u r I m
m o r I sh	m o r i sh I m
n e z i l A	n e z i l O t
p E l a x	p l a x I m
f r A j e r	f r A j e r i m
l a x U t	l a x u j O t
h i p o t E z a	h i p o t E z o t
sh f i t U t	sh f i t u j O t
k a l E t e t	k a l a t O t
j i b U	j i b u I m
k a m t U t	k a m t u t I m
m a h a p x a n U t	m a h a p x a n u j O t
z a k I f	z k i f I m
n i f k a d U t	n i f k a d u j O t
h e v h E k	h e v h e k I m
sh a l O m	sh l o m O t
m i t a m E n	m i t a m n I m
t i r g U l	t i r g u l I m
E t i k a	E t i k o t
x a sh a i j U t	x a sh a i j u j O t
l A x a n	l e x a n I m
b a k t E r j a	b a k t E r j o t
n o k d a n U t	n o k d a n u j O t
h a n a k A	h a n a k O t
d u m i j A	d u m i j O t
m e t I l	m e t i l I m
d o d a n I t	d o d a n i j O t
m e x a b E l	m e x a b l I m
t a l m I d	t a l m i d I m
h a f r a t A	h a f r a t O t
k a t v a n U t	k a t v a n u j O t
a ts A	a ts O t
h i t k a v ts U t	h i t k a v ts u j O t
g O r e n	g r a n O t
g a n A n	g a n a n I m
j i r A	j i r O t
t a m x I z	t a m x i z I m
p r o f E s o r	p r o f E s o r i m
b e t O n	b e t O n i m
o t O p s j a	o t O p s j o t
m i s d a r O n	m i s d r o n O t
k a a s A n	k a a s a n I m
t a x m I ts	t a x m i ts I m
k l a s i f i k A ts j a	k l a s i f i k A ts j o t
m A n j a	m A n j o t
h i t a n e n U t	h i t a n e n u j O t
t a v l I t	t a v l i j O t
x i b U k	x i b u k I m
d u g m a n U t	d u g m a n u j O t
h i t h a p x U t	h i t h a p x u j O t
p O l i g r a f	p O l i g r a f i m
a n o m A l j a	a n o m A l j o t
a k i d A	a k i d O t
s E l e r i	s E l e r i i m
s a f d a n U t	s a f d a n u j O t
p s a n t E r	p s a n t e r I m
sh E m	sh e m O t
m a x s O r	m a x s o r I m
sh a x e x a n U t	sh a x e x a n u j O t
sh x i t A	sh x i t O t
x a t i f A	x a t i f O t
n e x i x A	n e x i x O t
n e e m a n U t	n e e m a n u j O t
i n t e r E s	i n t e r E s i m
i t l u l A	i t l u l O t
f o r m a l I s t	f o r m a l I s t i m
t o k s I n	t o k s I n i m
a n a r x I s t	a n a r x I s t i m
j U l i	j U l i i m
e r O t i k a	e r O t i k o t
x i d o n A j	x i d o n a I m
p a r O sh	p a r o sh I m
a x b A r	a x b a r I m
m a d O n	m e d o n O t
p r o g r e s I v i j u t	p r o g r e s I v i j u j o t
a m i d A	a m i d O t
p O l	p o l I m
k i t l U g	k i t l u g I m
t O m	t o m I m
ts n o b A r	ts n o b a r I m
t E m a	t m a h I m
m u s A r	m u s a r I m
x a m i m U t	x a m i m u j O t
i n d o k t r i n A ts j a	i n d o k t r i n A ts j o t
m i g d a l O r	m i g d a l o r I m
m i k l A a t	m i k l a O t
t a x l I v	t a x l i v I m
j a r x O n	j a r x o n I m
d i n A m i j u t	d i n A m i j u j o t
x a n f a n U t	x a n f a n u j O t
r a a sh U sh	r a a sh u sh I m
x i sh m U l	x i sh m u l I m
t o x E n	t o x n I m
p r u d A	p r u d O t
O l	o l O t
t k u r A	t k u r O t
m i f t A x	m i f t a x I m
k s a j A	k s a j O t
z a j f A n	z a j f a n I m
m a r i x u A n a	m a r i x u A n o t
dZ i r A f	dZ i r A f i m
n i d O n	n i d o n I m
x i m U sh	x i m u sh I m
g i r U z	g i r u z I m
t a sh l I x	t a sh l i x I m
sh i t U f	sh i t u f I m
k O r p u s	k O r p u s i m
n E f e l	n e f a l I m
a m p l i t U d a	a m p l i t U d o t
sh e h i j A	sh e h i j O t
u z r A r	u z r a r I m
ts l a l I t	ts l a l i j O t
p E	p i j O t
g e n e r A t o r	g e n e r A t o r i m
t a r e l A	t a r e l O t
j e h u d I	j e h u d I m
n e g i sh U t	n e g i sh u j O t
m a r ts E	m a r ts I m
n e d i r U t	n e d i r u j O t
t a k i n U t	t a k i n u j O t
s O v e x	s o v a x I m
h a m t a k A	h a m t a k O t
h i t m a s m e s U t	h i t m a s m e s u j O t
s a r g E l	s a r g e l I m
m a n A m	m a n a m I m
m o n a r x I z e m	m o n a r x I z m i m
i r I d j u m	i r I d j u m i m
d E r b i	d E r b i i m
x O s e r	x o s a r I m
x e sh b o n I t	x e sh b o n i j O t
k i z U z	k i z u z I m
d a j k A n	d a j k a n I m
A s t m a	A s t m o t
h i t n a s U t	h i t n a s u j O t
a x l A n	a x l a n I m
h i z d a a z e U t	h i z d a a z e u j O t
r a b A t	r a b A t i m
p e u l A	p e u l O t
t a j f U n	t a j f U n i m
i v x A	i v x O t
e l e k t r O d a	e l e k t r O d o t
z i v A	z i v O t
b sh e l U t	b sh e l u j O t
o r g a n i z A t o r	o r g a n i z A t o r i m
r A a d	r e a d I m
p r A k t i j u t	p r A k t i j u j o t
ts e z U r a	ts e z U r o t
n A ts n a ts	n A ts n a ts i m
f r I dZ i d e r	f r I dZ i d e r i m
p n i j A	p n i j O t
m e t a p E l	m e t a p l I m
m a m O n	m e m o n O t
j o d I d	j o d I d i m
k a t a l O g	k a t a l O g i m
h a v a A	h a v a O t
x o ts E	x o ts I m
p A n d a	p A n d o t
m e n a k E d	m e n a k d I m
n i s p A x	n i s p a x I m
l o x E sh	l o x a sh I m
f i l o s O f j a	f i l o s O f j o t
d i m A	d m a O t
m o t E l	m o t E l i m
E m ts a	e m ts a I m
sh O v i	sh o v a I m
sh a m p U	sh a m p U i m
o k s i m o r O n	o k s i m o r O n i m
x a ts a I t	x a ts a i j O t
m i t l a m E d	m i t l a m d I m
p E r e k	p r a k I m
p r i x A	p r i x O t
m a ts A g	m a ts a g I m
h a n p a k A	h a n p a k O t
h i t a g d U t	h i t a g d u j O t
x a r U ts	x a r u ts I m
d i l e t A n t	d i l e t A n t i m
p r o t E z a	p r o t E z o t
n o d E d	n o d e d I m
h a k p a A	h a k p a O t
m i k r o s k O p	m i k r o s k O p i m
z i g z U g	z i g z u g I m
m u m x I t	m u m x i j O t
h i sh t a t x U t	h i sh t a t x u j O t
x o m r A	x o m r O t
r e ts i ts A	r e ts i ts O t
s a j E r e t	s a j a r O t
p r o d u k t I v i j u t	p r o d u k t I v i j u j o t
E m e r a l d	E m e r a l d i m
m i s j O n	m i s j O n i m
f a k s i m I l j a	f a k s i m I l j o t
E r e s	a r a s I m
s g i d A	s g i d O t
n i m n U m	n i m n u m I m
h i t p o ts e ts U t	h i t p o ts e ts u j O t
r e v i j A	r e v i j O t
m e u j A n	m e u j a n I m
t n u f A	t n u f O t
m i x r E	m i x r I m
t a h a r A n	t a h a r a n I m
m e ts i ts A	m e ts i ts O t
x a r ts I t	x a r ts i j O t
h a x k a r A	h a x k a r O t
h i t a d n U t	h i t a d n u j O t
E d e r	a d a r I m
g n U t	g n u j O t
n E t a x	n e t a x I m
p s i x o t e r A p j a	p s i x o t e r A p j o t
m e f a r E sh	m e f a r sh I m
O r e n	o r a n I m
a g A n	a g a n I m
p I n g w i n	p I n g w i n i m
h i sh t a m t U t	h i sh t a m t u j O t
n i h i l I z e m	n i h i l I z m i m
t O r	t o r O t
h a g sh a m A	h a g sh a m O t
t a r x A n	t a r x a n I m
l a h a t u t A n	l a h a t u t a n I m
h i t a t f U t	h i t a t f u j O t
ts i m ts U m	ts i m ts u m I m
h a sh t a x A	h a sh t a x O t
t i s b O x e t	t i s b o x O t
v E s p a	v E s p o t
sh a x m e t a U t	sh a x m e t a u j O t
s E n s o r	s E n s o r i m
p a x m A n	p a x m a n I m
m e r k a v A	m e r k a v O t
m i sh m U a	m i sh m u I m
m e d A l j a	m e d A l j o t
p a r k E t	p a r k E t i m
i l u s t r A ts j a	i l u s t r A ts j o t
p r A t	p r a t I m
p x A t	p x a t I m
g r i f O n	g r i f O n i m
m a g E v e t	m a g a v O t
h a f a k A	h a f a k O t
h i t j a v n U t	h i t j a v n u j O t
ts e e ts A	ts e e ts a I m
m i s k e n U t	m i s k e n u j O t
m a a m A s	m a a m a s I m
m i n h A g	m i n h a g I m
m a f k I d	m a f k i d I m
t o k E a	t o k I m
ts E p e l i n	ts E p e l i n i m
k r i j A	k r i j O t
b i j o s f E r a	b i j o s f E r o t
a k a r U t	a k a r u j O t
k a j t A n	k a j t a n I m
m e i n A	m e i n O t
s i U d	s i u d I m
sh E k a	sh k a I m
r i k o sh E t	r i k o sh E t i m
h a t m a n A	h a t m a n O t
x a j d A k	x a j d a k I m
a x j A n	a x j a n I m
s u b j e k t I v i j u t	s u b j e k t I v i j u j o t
x U t	x u t I m
k i v U ts	k i v u ts I m
o p e r A ts j a	o p e r A ts j o t
x a l a v l U v	x a l a v l u v I m
m a g A x	m a g A x i m
s e r e n A d a	s e r e n A d o t
a m i t i j U t	a m i t i j u j O t
m e u r A	m e u r O t
x a b u r A	x a b u r O t
g l i ts e r I n	g l i ts e r I n i m
k i r k U r	k i r k u r I m
t i r O sh	t i r o sh I m
m i sh A n	m i sh a n I m
h i t x a p s U t	h i t x a p s u j O t
k a b l A n	k a b l a n I m
k i b U j	k i b u j I m
m u v A n	m u v a n I m
p A n e l	p A n e l i m
sh a n s O n	sh a n s O n i m
m e x v A	m e x v O t
h a d r A n	h a d r A n i m
x e sh b o n A j	x e sh b o n a I m
h a b e a s   k O r p u s	h a b e a s   k O r p u s i m
k r i r U t	k r i r u j O t
k a v a n A	k a v a n O t
h i t n a g d U t	h i t n a g d u j O t
p l A n k t o n	p l A n k t o n i m
s a n e g O r	s a n e g O r i m
g i j U s	g i j u s I m
m u n a x O n	m u n a x o n I m
l E j z e r	l E j z e r i m
h i t g a l U t	h i t g a l u j O t
d r i s A	d r i s O t
sh i l U sh	sh i l u sh I m
p a p I r u s	p a p I r u s i m
sh a s t O m	sh a s t o m I m
x i v a r O n	x i v r o n O t
e m ts a I	e m ts a i I m
n a k A	n a k O t
x u r v A	x u r v O t
g E r e d	g r a d I m
r i k U z	r i k u z I m
h i sh t a l sh e l U t	h i sh t a l sh e l u j O t
m a x m e A	m a x m e O t
r e t i x A	r e t i x O t
t A l j a	t A l j o t
r E a	r e I m
d j E t a	d j E t o t
s i d r A	s d a r O t
x a t r a n U t	x a t r a n u j O t
b i l U j	b i l u j I m
s a p A n	s a p a n I m
p s i x o l O g j a	p s i x o l O g j o t
h o x a x A	h o x a x O t
m i r m A	m i r m O t
ts a p i x I t	ts a p i x i j O t
z i k n A	z i k n O t
z e e v i j U t	z e e v i j u j O t
p t i x A	p t i x O t
sh i x n U a	sh i x n u I m
m e n a k E v	m e n a k v I m
m i f l A s	m i f l a s I m
n e i ts A	n e i ts O t
i r a ts j o n A l i j u t	i r a ts j o n A l i j u j o t
t a r d a n U t	t a r d a n u j O t
m i f k a d A	m i f k a d O t
m u a m A d	m u a m a d I m
g a r s A n	g a r s a n I m
m E sh i	m E sh i i m
m a k r E n	m a k r e n I m
m e f a r n E s	m e f a r n e s I m
sh a a f t A n	sh a a f t a n I m
k e j l A f	k e j l a p O t
sh O x a d	sh o x a d I m
d i a f r A g m a	d i a f r A g m o t
x a k i k A	x a k i k O t
h i t k a sh t U t	h i t k a sh t u j O t
h a x l a f A	h a x l a f O t
a l m O g	a l m o g I m
s t r a d i v A r j u s	s t r a d i v A r j u s i m
sh a v sh E v e t	sh a v sh a v O t
k e a r A	k e a r O t
ts a l m a n i j A	ts a l m a n i j O t
h o z a l A	h o z a l O t
s a r I d	s r i d I m
p s U l	p s u l I m
h i m U r	h i m u r I m
z n i k A	z n i k O t
l A a z	l e a z I m
v i t r I n a	v i t r I n o t
k r A v	k r a v O t
a n sh O v i	a n sh O v i m
sh O sh	sh O sh i m
n e x i sh U t	n e x i sh u j O t
t a x b e l A n	t a x b e l a n I m
t o k E f	t o k f I m
d u m A	d u m O t
t E m p o	t E m p o i m
f e m i n I s t	f e m i n I s t i m
s ts E n a	s ts E n o t
s i m b O l i k a	s i m b O l i k o t
n a n A s	n a n a s I m
t a v j A n	t a v j a n I m
h i s t o f e f U t	h i s t o f e f u j O t
z a r A z	z a r a z I m
a m A m	a m a m I m
k a ts E f e t	k a ts a f O t
e d n A	e d n O t
p a r i t E t i j u t	p a r i t E t i j u j o t
r a b A	r a b O t
h i sh t a h U t	h i sh t a h u j O t
sh a r k A n	sh a r k a n I m
p E r e ts	p r a ts I m
o m E g a	o m E g o t
r I s k	r I s k i m
s a d a r U t	s a d a r u j O t
m u d a U t	m u d a u j O t
r a f t a n U t	r a f t a n u j O t
n E k a	n e k a I m
p a n t e O n	p a n t e O n i m
g i d U l	g i d u l I m
s a d A n	s a d a n I m
p E s a x	p s a x I m
r E p l i k a	r E p l i k o t
b U n d	b U n d i m
k ts i ts A	k ts i ts O t
j a z A m	j a z a m I m
l i k U d	l i k u d I m
h E p e n i n g	h E p e n i n g i m
p i t p U t	p i t p u t I m
k o m p r E s o r	k o m p r E s o r i m
x e r U t	x e r u j O t
t a m r I ts	t a m r i ts I m
k v u d A	k v u d O t
k o s E m	k o s m I m
d e a v O n	d e a v o n O t
m u v a n U t	m u v a n u j O t
p k i d A	p k i d O t
l u l j a n U t	l u l j a n u j O t
b l O k	b l O k i m
a v x a n A	a v x a n O t
h i t U x	h i t u x I m
m e x o r A	m e x o r O t
E s e v	a s a b I m
m a r x A n	m a r x a n I m
n a x sh O l	n a x sh o l I m
k v i j A	k v i j O t
t a v e r A	t a v e r O t
m e a h E v e t	m e a h a v O t
m a ts r E f	m a ts r e f I m
s t E n s i l	s t E n s i l i m
h e s g E r	h e s g e r I m
t r i b U n	t r i b U n i m
d e p o l i t i z A ts j a	d e p o l i t i z A ts j o t
sh f e l A	sh f e l O t
x u p A	x u p O t
a x e r U t	a x e r u j O t
h i t j a g U t	h i t j a g u j O t
b e ts i A	b e ts i O t
sh x i x U t	sh x i x u j O t
a l A m	a l A m i m
k sh i r U t	k sh i r u j O t
h a v r a k A	h a v r a k O t
j E sh a	j e sh a I m
r a x sh U sh	r a x sh u sh I m
n A a r	n e a r I m
i l E m	i l m I m
s a f l U l	s a f l u l I m
m a r ts e p A n	m a r ts e p A n i m
h a m l a t A	h a m l a t O t
m a d O n a	m a d O n o t
h a g i n U t	h a g i n u j O t
t o r A n	t o r a n I m
m e g I v	m e g i v I m
p a r a n O j a	p a r a n O j o t
h a x ts a f A	h a x ts a f O t
m A j	m A j i m
j o m O n	j o m o n I m
sh a t j A n	sh a t j a n I m
z r i x A	z r i x O t
h i t a m U t	h i t a m u j O t
m a v r I	m a v r i I m
h e k E f	h e k e f I m
p a k p e k A n	p a k p e k a n I m
m E z a x	m e z a x I m
a f i ts U t	a f i ts u j O t
h a s a m A	h a s a m O t
x O m e r	x o m a r I m
m a k r E r	m a k r e r I m
sh u x A	sh u x O t
m e r i t o k r A t j a	m e r i t o k r A t j o t
k o s I t	k o s i j O t
r I k	r i k I m
k r i A	k r i O t
b U k	b U k i m
r E j sh	r E j sh i m
v u l g A r i j u t	v u l g A r i j u j o t
k i n j A n	k i n j a n I m
t r i k A	t r i k O t
r I v	r i v I m
m a a s i j A	m a a s i j O t
j e v U l	j e v u l I m
j a b a sh A	j a b a sh O t
n u t r a l i z A ts j a	n u t r a l i z A ts j o t
r e a j O n	r e a j o n O t
g E v e r	g v a r I m
m i t U t	m i t u t I m
o l A	o l O t
z a m I r	z m i r I m
k i U r	k i u r I m
x a s i l O n	x a s i l o n I m
m a t E z	m a t e z I m
f e j A	f e j O t
r i r A n	r i r a n I m
l e k s i k o g r A f j a	l e k s i k o g r A f j o t
z E v e l	z v a l I m
s A r	s a r I m
m o sh a v A	m o sh a v O t
p i r o m A n j a	p i r o m A n j o t
e g i p t o l O g	e g i p t o l O g i m
n e x i l A	n e x i l O t
a x s A n j a	a x s A n j o t
m a a m A r	m a a m a r I m
h a m x a sh A	h a m x a sh O t
b a ts E k	b ts e k I m
t o a l t a n U t	t o a l t a n u j O t
sh i b U sh	sh i b u sh I m
k a b a l A	k a b a l O t
i s I	i s i I m
sh a w A r m a	sh a w A r m o t
s i t v a n I t	s i t v a n i j O t
sh v i I t	sh v i i j O t
k a n a U t	k a n a u j O t
e f O d	e f o d I m
sh O k o	sh O k o i m
m i l o n A j	m i l o n a j I m
l I r a	l I r o t
m a h U t	m a h u j O t
t v i A	t v i O t
i d e A l	i d e A l i m
m i z U r	m i z u r I m
d i v U sh	d i v u sh I m
b r i g A d a	b r i g A d o t
sh o m E r	sh o m r I m
m i ts r A x	m i ts r a x I m
f r A k	f r A k i m
k i ts b A	k i ts b a O t
a f s i j U t	a f s i j u j O t
j e r u sh A	j e r u sh O t
sh o f A r	sh o f a r O t
k l i A	k l i O t
h i t m a r x U t	h i t m a r x u j O t
b a m A	b a m O t
n a f sh i j U t	n a f sh i j u j O t
p o x E a x	p o x e x I m
h e r k E v	h e r k e v I m
E ts e m	a ts a m O t
x e m A	x e m O t
n O f	n o f I m
s i k U l	s i k u l I m
k O l e l	k O l e l i m
g d I	g d a I m
a n a r x I z e m	a n a r x I z m i m
x a j A l	x a j a l I m
e m i r U t	e m i r u j O t
ts A v t a	ts A v t o t
k l a s t r o f O b j a	k l a s t r o f O b j o t
k i sh k U sh	k i sh k u sh I m
a x i d U t	a x i d u j O t
s a j A r	s a j a r I m
p u l m u s a n U t	p u l m u s a n u j O t
g z u z t r A	g z u z t r a O t
t a l E	t l a I m
d o k t r I n a	d o k t r I n o t
m e o r a v U t	m e o r a v u j O t
s i f r U t	s i f r u j O t
d a k A	d a k O t
h a r k a n A	h a r k a n O t
m a ts E k e t	m a ts a k O t
x a sh m A n	x a sh m a n I m
sh i v j O n	sh i v j o n O t
b u t I k	b u t I k i m
t i a t U k	t i a t u k I m
d e f E k t	d e f E k t i m
d r a sh A	d r a sh O t
m a x v A n	m a x v a n I m
k u l A	k u l O t
m i sh k A n	m i sh k a n I m
I s t r a	I s t r o t
b i m A j	b i m a I m
s f i g A	s f i g O t
x a r I g	x a r i g I m
h a d g a m A	h a d g a m O t
e k s p o z I ts j a	e k s p o z I ts j o t
m e j u x a d U t	m e j u x a d u j O t
a x z a v A	a x z a v O t
t a k a n A	t a k a n O t
s t i m A	s t i m O t
l e k i x A	l e k i x O t
t a k ts I v	t a k ts i v I m
g a sh m i j U t	g a sh m i j u j O t
g a a sh i j U t	g a a sh i j u j O t
m a h a l u m A	m a h a l u m O t
h a sh l a m A	h a sh l a m O t
a s k u p A	a s k u p O t
t n u A	t n u O t
a d n U t	a d n u j O t
zh I d	zh I d i m
f o r m A ts j a	f o r m A ts j o t
b r I dZ	b r I dZ i m
m e r U r	m e r u r I m
n i r m U l	n i r m u l I m
s a r A f	s r a f I m
s a t i r i k A n	s a t i r i k A n i m
p a t sh E g e n	p a t sh e g a n I m
b a r I a x	b r i x I m
f E b r u a r	f E b r u a r i m
r a sh l a n U t	r a sh l a n u j O t
t e i j A	t e i j O t
k o r E	k o r I m
r I tS r a tS	r I tS r a tS i m
k r a v i j U t	k r a v i j u j O t
k r E d i t	k r E d i t i m
a r p A d	a r p a d I m
i v sh A	i v sh O t
m a f t E a x	m a f t e x O t
n i k U v	n i k u v I m
h e x a s f U t	h e x a s f u j O t
f o n o g r A f	f o n o g r A f i m
h i t b a ts r U t	h i t b a ts r u j O t
ts a j A r	ts a j a r I m
m a a x E l e t	m a a x a l O t
a v n U n	a v n u n I m
r i t m A	r i t m O t
k E r a x	k r a x I m
h E l j u m	h E l j u m i m
h a l a t A	h a l a t O t
j e r i j A	j e r i j O t
E s k i m o	E s k i m o i m
r e v i A	r e v i O t
g a v I sh	g v i sh I m
d i k l U m	d i k l u m I m
m e I	m e i I m
k o n E s	k o n s I m
a r i k A	a r i k O t
s i d U r	s i d u r I m
a g n O s t i j u t	a g n O s t i j u j o t
s a r v A n	s a r v a n I m
g r A f	g r A f i m
O m	O m i m
i m p r e s j o n I s t	i m p r e s j o n I s t i m
n e s i b A	n e s i b O t
x i s a j O n	x e s j o n O t
i n d i k A ts j a	i n d i k A ts j o t
sh i sh A b a t	sh i sh A b a t i m
sh i k U x	sh i k u x I m
n e h i j A	n e h i j O t
x O r	x o r I m
h i t j a d e d U t	h i t j a d e d u j O t
i b U k	i b u k I m
E v e d	a v a d I m
z a l z e l A n	z a l z e l a n I m
h i t j a a sh U t	h i t j a a sh u j O t
h a r m O n j a	h a r m O n j o t
p a r O x e t	p a r o x O t
p o p u l a r i z A ts j a	p o p u l a r i z A ts j o t
z a g A g	z a g a g I m
h o g E n	h o g n I m
p sh i A	p sh i O t
g o r g O n a	g o n g O n o t
sh E ts e f	sh ts a f I m
h i g U j	h i g u j I m
ts i k l O n	ts i k l O n i m
j a x s a n U t	j a x s a n u j O t
k o m U n a	k o m U n o t
i j U r	i j u r I m
k a k A o	k a k A o i m
i n U j	i n u j I m
i m p r o v i z A ts j a	i m p r o v i z A ts j o t
t a r s I s	t a r s i s I m
p a r a d I g m a	p a r a d I g m o t
b a d l A n	b a d l a n I m
k a n j A n	k a n j a n I m
d i m j O n	d i m j o n O t
m i s x A r	m i s x a r I m
j i ts U v	j i ts u v I m
m i sh l A x a t	m i sh l a x O t
s A m b a	s A m b o t
s i f r u t i j U t	s i f r u t i j u j O t
m e x a d E d	m e x a d e d I m
n e m i j A	n e m i j O t
b E d e k	b d a k I m
A r a k	A r a k i m
h i n a k t U t	h i n a k t u j O t
d E sh e n	d sh a n I m
m o n t A zh	m o n t A zh i m
m a x b E t	m a x b e t I m
u sh p I z	u sh p i z I m
m a k E l	m a k l O t
r e x i sh A	r e x i sh O t
sh i x l U l	sh i x l u l I m
m a r b E k	m a r b e k I m
p r o p E l o r	p r o p E l o r i m
n E v e t	n e v a t I m
k E v e sh	k v a sh I m
m o d E r n i j u t	m o d E r n i j u j o t
x E r e m	x a r a m O t
g a l I n	g a l i n I m
h i t p a a l U t	h i t p a a l u j O t
o m a n U t	o m a n u j O t
x u r sh A f	x u r sh a f I m
d e k a E d e r	d e k a E d r i m
n i l b a v U t	n i l b a v u j O t
j a ts I a	j e ts i I m
ts a m E r e t	ts a m a r O t
g a l a n t E r j a	g a l a n t E r j o t
sh u n I t	sh u n i j O t
t a x a r A	t a x a r O t
m e x ts A v	m e x ts a v I m
x o l I t	x o l i j O t
p r o z O d j a	p r o z O d j o t
a g A m	a g a m I m
r e U t	r e u j O t
ts a j A d	ts a j a d I m
m i j a d i j U t	m i j a d i j u j O t
i r O n j a	i r O n j o t
s f i d A	s f i d O t
a l x u t A n	a l x u t a n I m
h i t l a k d U t	h i t l a k d u j O t
m u v l A a t	m u v l a O t
m a sh g I a x	m a sh g i x I m
b e r e sh i t i j U t	b e r e sh i t i j u j O t
n O h a l	n o h a l I m
sh A j	sh a j I m
m e g a l o m A n j a	m e g a l o m A n j o t
x o l E m	x o l m I m
m a z m e r A	m a z m e r O t
x i v r U t	x i v r u t I m
h a sh k a t A	h a sh k a t O t
a r I ts	a r i ts I m
h i t x a l f U t	h i t x a l f u j O t
ts r I f	ts r i f I m
sh i r b U v	sh i r b u v I m
sh i r O k o	sh i r O k o i m
i b U d	i b u d I m
l i k U j	l i k u j I m
h a l a ts A	h a l a ts O t
f o s f A t	f o s f A t i m
m a r k O l	m a r k o l I m
s i m E t r i j a	s i m E t r i j o t
h i t g a sh m U t	h i t g a sh m u j O t
m i t v A x	m i t v a x I m
b i d E	b i d E i m
sh l i sh I t	sh l i sh i j O t
m i k b A ts	m i k b a ts I m
p l A s t i j u t	p l A s t i j u j o t
z A m sh	z A m sh i m
m u z i k A j	m u z i k A i m
ts i f x A	ts i f x O t
m a n O d	m a n o d I m
p n I m	p n i m I m
k i p O d	k i p o d I m
m i t x A m	m i t x a m I m
r i r i j U t	r i r i j u j O t
t a n f A n	t a n f a n I m
n e t i j A	n e t i j O t
p t O r	p t O r i m
b u k i n I s t	b u k i n I s t i m
m a m A sh	m a m a sh I m
m a g d I r	m a g d i r I m
s a r I g	s r i g I m
b a r v a z O n	b a r v a z o n I m
h a x a j a A	h a x a j a O t
p l a n e t A r j u m	p l a n e t A r j u m i m
sh i x e x A	sh i x e x O t
b a l A d a	b a l A d o t
h i sh t o l e l U t	h i sh t o l e l u j O t
k A d	k a d I m
h i t g a l m U t	h i t g a l m u j O t
h e f s E d	h e f s e d I m
a t O n	a t o n O t
t i r x A	t i r x O t
a sh r A	a sh r O t
h i t r a k m U t	h i t r a k m u j O t
s i k U l	s i k u l I m
p a t A x	p a t a x I m
m i sh k O l e t	m i sh k o l O t
h a sh k a n A	h a sh k a n O t
z e i r U t	z e i r u j O t
t l i sh A	t l i sh O t
m a l g e z A	m a l g e z O t
m i sh m U sh	m i sh m u sh I m
k E l a x	k l a x I m
m a a b O r e t	m a a b o r O t
x a m i ts U t	x a m i ts u j O t
h e d o n I s t	h e d o n I s t i m
a r v U t	a r v u j O t
z a r b U v	z a r b u v I m
h a x a l A	h a x a l O t
p a j t A n	p a j t a n I m
m e j u t a r U t	m e j u t a r u j O t
m i t k a f A	m i t k a f O t
o f I r	o f I r i m
b i t U j	b i t u j I m
m u m x i j U t	m u m x i j u j O t
k v I sh	k v i sh I m
k E n	k i n I m
r i sh U t	r i sh u j O t
h i t x a n x e n U t	h i t x a n x e n u j O t
sh A x a r	sh a x a r I m
h i t a v t U t	h i t a v t u j O t
r i b o n i j U t	r i b o n i j u j O t
l E s e t	l e s a t O t
m e U n	m e u n I m
k d i x A	k d i x O t
h a x sh a d A	h a x sh a d O t
E z e r	a z a r I m
x u ts p a n U t	x u ts p a n u j O t
h i ts t a m k U t	h i ts t a m k u j O t
k i n O r	k i n o r O t
p i r x A x	p i r x a x I m
g i b U sh	g i b u sh I m
h a r p a j A	h a r p a j O t
m u f k a r U t	m u f k a r u j O t
x a k j A n	x a k j a n I m
sh v i i j A	sh v i i j O t
p i t k A	p i t k a O t
h i t k a a r U t	h i t k a a r u j O t
n I r	n i r I m
ts a n E r e t	ts a n a r O t
k e d a i j U t	k e d a i j u j O t
k O r a x	k o r a x I m
b A k x u s	b A k x u s i m
a sh m O r e t	a sh m o r O t
t i g b U r	t i g b u r I m
p o l a r i z A ts j a	p o l a r i z A ts j o t
ts a j t a n U t	ts a j t a n u j O t
s o v E	s o v I m
m a t a t E	m e t a t I m
i l u m i n A ts j a	i l u m i n A ts j o t
h i t m a x U t	h i t m a x u j O t
h i t r a v r e v U t	h i t r a v r e v u j O t
p l A z m a	p l A z m o t
h a l v a j A	h a l v a j O t
k O ts e r	k o ts a r I m
h a x t a v A	h a x t a v O t
m a h a p x A n	m a h a p x a n I m
l i m O n	l i m o n I m
a m b I ts j a	a m b I ts j o t
k v i sh A	k v i sh O t
ts l A v	ts l a v I m
m e a v r E r	m e a v r e r I m
x e sh b O n	x e sh b o n O t
m i n h A l	m i n h a l I m
k t O v e t	k t o v O t
h i t n a k r U t	h i t n a k r u j O t
m e a l E m e t	m e a l m O t
n a j E r e t	n a j a r O t
k u r s A	k u r s a O t
z a n A v	z n a v O t
k a w tS U k	k a w tS U k i m
a g u d A l	a g u d a l I m
d A m k a	d A m k o t
d O f i	d f a I m
i t U j	i t u j I m
r E k v i e m	r E k v i e m i m
sh i m a m O n	sh i m a m o n I m
k a d A x a t	k a d a x O t
h i sh t a k f U t	h i sh t a k f u j O t
m i k A x	m i k a x I m
ts i j o n i j U t	ts i j o n i j u j O t
sh E v e t	sh v a t I m
o k t A n	o k t A n i m
b i t U k	b i t u k I m
ts a n x A n	ts a n x a n I m
a g u d A	a g u d O t
m e t I v	m e t i v I m
k n i s A	k n i s O t
j O g a	j O g o t
k o t E v	k o t v I m
sh x i t U t	sh x i t u j O t
t i n O f e t	t i n o f O t
k a m t A r	k a m t a r I m
a g a l g a l U t	a g a l g a l u j O t
i l U l	i l u l I m
ts v i r A	ts v i r O t
a x i f A	a x i f O t
x i r x U r	x i r x u r I m
n o ts E r	n o ts r I m
a b A m	a b A m i m
g o n d o l j E r	g o n d o l j E r i m
o r d i n A t a	o r d i n A t o t
p e s i m I s t	p e s i m I s t i m
m e t i x U t	m e t i x u j O t
s a r A	s a r O t
s i A n	s i a n I m
t A v	t a v I m
r a x E l	r e x e l O t
h a sh p a l A	h a sh p a l O t
x i l U f	x i l u f I m
z a l f A n	z a l f a n I m
ts A f r a	ts A f r o t
e l I	e l i I m
r a k E v e t	r a k a v O t
x a r I sh	x a r i sh I m
m u x a sh U t	m u x a sh u j O t
a v a t I a x	a v a t i x I m
x a sh A sh	x a sh a sh O t
b o k E r	b o k r I m
sh E d e r	sh d a r I m
h i sh t a g U t	h i sh t a g u j O t
m a t l I t	m a t l i j O t
a ts i l A	a ts i l O t
k u s E m e t	k u s a m O t
h i t x a n f U t	h i t x a n f u j O t
m o s a d i j U t	m o s a d i j u j O t
n e d i d A	n e d i d O t
k E r e s	k r a s I m
l O g o s	l O g o s i m
O p u s	O p u s i m
m a a m a s A	m a a m a s O t
p a l A d j u m	p a l A d j u m i m
sh a a n U t	sh a a n u j O t
s O v a	s o v a I m
r e h i t U t	r e h i t u j O t
h o f a A	h o f a O t
s a s O n	s a s o n O t
m e I t	m e i j O t
t a p I r	t a p i r I m
f r a g m E n t	f r a g m E n t i m
n a x sh o n U t	n a x sh o n u j O t
t a l A g	t a l A g i m
sh i j U t	sh i j u t I m
d e i x A	d e i x O t
h o l E l	h o l e l I m
g e i j A	g e i j O t
x a sh m a l I t	x a sh m a l i j O t
b a g r U t	b a g r u j O t
k a n O n	k a n O n i m
m a r k o l I t	m a r k o l i t I m
h i t d a m U t	h i t d a m u j O t
t A n g o	t A n g o i m
m i d r O n	m i d r o n O t
j e n i k A	j e n i k O t
sh A x a f	sh x a f I m
m o n o p O l	m o n o p O l i m
h e r a t U t	h e r a t u j O t
m o d E l	m o d E l i m
s t a l a g m I t	s t a l a g m I t i m
k a r e k a t U r a	k a r e k a t U r o t
a d m i n i s t r A t o r	a d m i n i s t r A t o r i m
k a s p I t	k a s p i j O t
m a a r x O n	m a a r x o n I m
x u l i g A n	x u l i g A n i m
x e z k A	x e z k O t
ts u r A	ts u r O t
f j O r d	f j O r d i m
m e r a ts E a x	m e r a ts x I m
e f E k t	e f E k t i m
m i ts A d	m i ts a d I m
a r p I a x	a r p i x I m
i l U z j a	i l U z j o t
s u s O n	s u s o n I m
p r o t o k O l	p r o t o k O l i m
o g E r e t	o g r O t
a k m u m I t	a k m u m i j O t
t a v h e l A	t a v h e l O t
h i t a p sh U t	h i t a p sh u j O t
k o m A	k o m O t
g i n U j	g i n u j I m
m a r p e k A n	m a r p e k a n I m
b i z U j	b i z u j I m
g u n d A	g u n d O t
g a v A n	g v a n I m
ts A g	ts a g I m
h e r a m s U t	h e r a m s u j O t
m I k s	m I k s i m
m e z i g A	m e z i g O t
a sh k a v A	a sh k a v O t
x a t I f	x a t i f I m
m a a d E r	m a a d e r I m
m e h a d E k	m e h a d k I m
m e s u r A	m e s u r O t
p A x	p a x I m
t O f	t u p I m
g a l I l	g l i l I m
a n t i p A t j a	a n t i p A t j o t
m i r p E s e t	m i r p a s O t
i v r U r	i v r u r I m
k O m e r	k m a r I m
h i t a ts m U t	h i t a ts m u j O t
p l e b E i	p l e b E i m
m e r U k	m e r u k I m
m a r U t	m a r u j O t
d E v e r	d v a r I m
r a m A j	r a m a I m

